丁	一 亅
丂	一 乙
七	丿 乚
丄	丨 一
丅	一 丨
万	一 刀
丈	一 乂
三	一 一 一
上	丶 丨 一
下	一 丨 丶
丌	一 丿 丨
不	一 丿 丨 丶
丐	正 丿
丑	㇆ 一 丨 一
丒	刃 一
且	月 一
丕	不 一
世	廿 丨 一
丗	十 凵
丘	厂 丅 一
丙	一 人 冂
丞	氶 一
丢	丿 去
丠	北 一
両	一 山 冂
并	丷 开
丫	丶 丶 丨
丬	冫 丨
中	口 丨
丮	乁 二 丨
丯	丨 彡
丰	三 丨
串	中 口
丳	串 丿
丵	业 丷 干
丷	丶 丿
丸	丶 九
丹	冂 丶 一
主	丶 王
丼	井 丶
乂	乀 丿
乃	丿 ㇆ ㇆
久	丿 入
乆	𠃊 人
乇	丿 七
幺	𠃊 厶
乍	丿 丅 二
乎	丿 丷 一 亅
乏	丿 之
乑	丿 丨 丿 丿 丶 乀
乒	丘 丿
乓	丘 丶
乕	厂 二 巾
乖	千 北
乘	禾 北
乘	禾 丬 匕
乜	卩 乚
九	丿 乙
乞	丿 一 乙
也	卩 丨 乚
乢	山 乚
乣	幺 乚
乨	台 乚
乩	占 乙
乪	乙 田
乫	加 乙
乭	石 乙
乳	孚 乙
乴	折 乙
乵	辛 乚
乶	甫 乙
乷	沙 乙
乸	也 母
乹	十 日 十 乚
干	一 十
乿	爫 糸 乚
亀	龟 曰
亁	十 日 干 乞
乱	舌 乚
亃	粦 乚
亄	壹 乚
了	乛 亅
予	龴 乛 亅
亊	一 丷 亅 肀
事	一 口 肀
二	一 一
亍	一 丁
于	二 亅
亐	一 丂
云	二 厶
互	一 彑
亓	一 丌
五	二 丨 ㇆
井	二 丿 丨
亖	二 二
亗	山 二
亘	二 日
些	此 二
亚	一 业
亝	厽 二
亚	一 业
亟	丂 口 又 一
亠	丶 一
亡	丶 匸
亢	亠 几
亣	丶 丌
交	亠 父
亦	亠 丿 亅 八
亨	亠 口 了
享	亠 口 子
京	亠 口 小
亭	亠 口 冖 丁
亮	亠 口 冖 儿
亯	亠 口 日
亰	亠 日 小
亱	亠 但
亳	亠 口 冂 乇
亴	亠 口 冂 土 九
亶	亠 回 旦
亷	亠 兼 丿
亹	亠 舋
人	丿 乀
亻	丿 丨
亼	人 一
亾	丨 一 人
什	亻 十
仁	亻 二
仂	亻 力
仃	亻 丁
仄	厂 人
仆	亻 卜
仇	亻 九
仈	亻 八
仉	亻 几
今	人 丶 乛
介	人 丿 丨
仌	人 人
仍	亻 乃
仏	亻 厶
仐	人 十
仒	人 冫
仔	亻 子
仕	亻 士
他	亻 也
仗	亻 丈
付	亻 寸
仙	亻 山
仚	人 山
仛	亻 乇
仜	亻 工
同	冂 一 口
仞	亻 刃
仟	亻 千
仠	亻 干
仡	亻 乞
仢	亻 勺
代	亻 弋
令	人 一 卩
仦	亻 小
仧	上 人
仨	亻 三
仫	亻 么
仭	亻 刄
仮	亻 反
仯	亻 少
仰	亻 卬
仱	亻 今
仲	亻 中
仳	亻 比
仴	亻 月
仵	亻 午
件	亻 牛
仸	亻 夭
仹	亻 丰
仺	人 匚 一
任	亻 壬
仼	亻 王
份	亻 分
仾	亻 互
仿	亻 方
伀	亻 公
企	人 止
伂	亻 巿
伃	亻 予
伄	亻 弔
伅	亻 屯
伆	亻 勿
伇	亻 殳
伈	亻 心
伉	亻 亢
伊	亻 尹
伋	亻 及
伌	亻 厄
伍	亻 五
伎	亻 支
伏	亻 犬
伐	亻 戈
休	亻 木
伒	亻 斤
伓	亻 不
伔	亻 冗
伕	亻 夫
伖	亻 友
伙	亻 火
伜	亻 卆
伢	亻 牙
伨	人 匀
伩	亻 文
伭	亻 玄
伮	亻 奴
伯	亻 白
估	亻 古
伱	亻 尒
伲	亻 尼
伳	亻 世
伴	人 半
伵	亻 四
伶	亻 令
伷	亻 由
伸	亻 申
伹	亻 且
伺	亻 司
伻	亻 平
似	亻 以
伽	亻 加
伾	亻 丕
伿	亻 只
佀	亻 尸 乛 一
佁	亻 台
佂	亻 正
佃	亻 田
佄	亻 甘
佅	亻 未
但	亻 旦
伫	亻 宀 一
布	一 丿 巾
佉	亻 去
佊	亻 皮
佋	亻 召
佌	亻 此
位	亻 立
低	亻 氐
住	亻 主
佐	亻 左
佑	亻 右
佒	亻 央
佔	亻 占
何	亻 可
佖	亻 必
佗	亻 它
佘	人 示
余	人 于 八
佚	亻 失
佛	亻 弗
作	亻 乍
佝	亻 句
佞	亻 二 女
佟	亻 冬
你	亻 尔
佡	亻 仚
佢	亻 巨
佣	亻 用
佤	亻 瓦
佧	亻 卡
佩	亻 几 帀
佪	亻 回
佫	亻 各
佬	亻 老
佭	亻 夅
佮	亻 合
佯	亻 羊
佰	亻 百
佱	亻 一 正
佲	亻 名
佳	亻 圭
佴	亻 耳
并	丷 开
佶	亻 吉
佷	亻 艮
佸	亻 舌
佹	亻 危
佺	亻 全
佻	亻 兆
佼	亻 交
佽	亻 次
佾	亻 八 月
使	亻 吏
侀	亻 刑
侁	亻 先
侂	亻 广 乇
侃	亻 口 川
侄	亻 至
侅	亻 亥
来	一 米
侇	亻 夷
侈	亻 多
侉	亻 夸
侊	亻 光
例	亻 列
侌	今 云
侍	亻 寺
侎	亻 米
侏	亻 朱
侐	亻 血
侑	亻 有
侒	亻 安
侓	亻 聿
侔	亻 牟
侕	亻 而
仑	人 匕
侗	亻 同
侘	亻 宅
侙	亻 式
侚	亻 旬
供	亻 共
侜	亻 舟
依	亻 衣
侞	亻 如
侟	亻 存
价	亻 介
侢	亻 再
侫	亻 忘
侭	亻 尽
侮	亻 每
侯	亻 乛 一 矢
侰	亻 君
侱	亻 呈
侲	亻 辰
侳	亻 坐
侴	人 一 丑 刂
侵	亻 彐 冖 又
侣	亻 吕
侷	亻 局
侸	亻 豆
侹	亻 廷
侺	亻 岑
侻	亻 兌
侼	亻 孛
侽	亻 男
侾	亻 孝
便	亻 更
俀	亻 妥
俣	亻 吴
系	丿 幺 小
促	亻 足
俄	亻 我
俅	亻 求
俆	亻 余
俇	亻 狂
俈	亻 告
俉	亻 吾
俊	亻 夋
俋	亻 邑
俌	亻 甫
俍	亻 良
俎	仌 且
俏	亻 肖
俐	亻 利
俑	亻 甬
俒	亻 完
伣	亻 见
俕	亻 宋
俖	亻 否
俗	亻 谷
俘	亻 孚
俙	亻 希
俚	亻 里
俛	亻 免
俜	亻 甹
保	亻 呆
俞	人 一 月 刂
俟	亻 矣
侠	亻 夹
信	亻 言
俢	亻 夂 彡
俤	亻 弟
伡	亻 车
修	攸 彡
俯	亻 府
俰	亻 和
俱	亻 具
俲	亻 効
俳	亻 非
俵	亻 表
俶	亻 叔
俷	亻 肥
俸	亻 奉
俺	人 奄
俻	亻 备
俼	亻 育
俽	亻 欣
俾	亻 卑
俿	亻 虎
伥	亻 长
倁	亻 知
併	亻 并
倃	亻 咎
倄	亻 肴
倅	亻 卒
俩	亻 两
倇	亻 宛
俫	亻 来
仓	人 㔾
倊	亻 忩
个	人 丨
倌	亻 官
倍	亻 咅
倎	亻 典
倏	攸 犬
倐	攸 火
们	亻 门
倒	亻 到
倓	亻 炎
倔	亻 屈
倕	亻 垂
幸	土 羊
倗	亻 朋
倘	亻 尚
候	亻 丨 乛 一 矢
倚	亻 奇
倛	亻 其
倜	亻 周
倝	十 日 十 人
倞	亻 京
借	亻 昔
倠	人 隹
倡	亻 昌
倢	亻 疌
倣	亻 放
値	亻 直
倥	亻 空
倦	亻 卷
倧	亻 宗
倨	亻 居
倩	亻 青
倪	亻 兒
伦	亻 仑
倬	亻 卓
倭	亻 委
倮	亻 果
倯	亻 松
倰	亻 夌
倱	亻 昆
倳	亻 事
倴	亻 奔
倵	亻 武
倶	亻 具
倷	亻 奈
倸	亻 采
俭	亻 佥
倻	亻 耶
值	亻 直
倽	亻 舍
偀	亻 英
偁	亻 爯
偂	亻 前
偃	亻 匽
偄	亻 耎
偅	亻 重
偆	亻 春
假	亻 叚
偈	亻 曷
伟	亻 韦
偊	亻 禹
偋	亻 屏
偌	亻 若
偍	亻 是
偎	亻 畏
偏	亻 扁
偐	亻 彦
偒	亻 易
偓	亻 屋
偔	亻 咢
偕	亻 皆
偖	亻 者
偗	亻 省
偘	亻 品
偙	亻 帝
做	亻 故
偛	亻 臿
停	亻 亭
偝	亻 背
偞	亻 枼
偟	亻 皇
偠	亻 要
偡	亻 甚
偢	亻 秋
偣	亻 音
偤	亻 酋
健	亻 建
偦	亻 女 疋
偧	亻 大 多
偨	亻 奓
偪	亻 畐
偫	亻 待
偬	亻 怱
偭	亻 面
偮	亻 咠
偯	亻 哀
偰	亻 契
偱	亻 盾
偲	亻 思
偳	亻 耑
侧	亻 则
侦	亻 贞
偶	亻 禺
偷	亻 俞
偷	亻 俞
偹	人 丨 备
偺	亻 昝
偼	亻 疌
伪	亻 为
傀	亻 鬼
傁	亻 叟
傂	亻 虒
傃	亻 素
傄	亻 眘
傅	亻 甫 寸
傆	亻 原
傇	亻 茸
傈	亻 栗
傉	亻 辱
傋	亻 冓
傌	亻 馬
傍	人 旁
傎	亻 真
傏	亻 唐
傐	亻 高
杰	木 灬
傒	亻 奚
傓	亻 扇
傔	亻 丶 丶 兼
傕	亻 隺
伧	亻 仓
傗	亻 畜
伞	人 丷 十
备	夂 田
傚	人 交 攵
傛	亻 容
傝	亻 日 羽
傞	亻 差
傟	亻 翁
傡	亻 竝
家	宀 豕
傣	亻 泰
傫	亻 累
催	亻 崔
佣	亻 用
傮	亻 曹
傯	亻 悤
傰	亻 崩
傲	人 敖
传	亻 专
伛	亻 区
债	亻 责
傶	亻 戚
伤	亻 丿 一 力
傸	亻 爽
傹	亻 竟
傺	亻 祭
傻	亻 囟 儿 夂
傼	亻 革 大
傽	亻 章
倾	亻 顷
傿	亻 焉
僁	亻 悉
偻	亻 娄
僃	人 艸 勹 用
僄	亻 票
仅	亻 又
僇	亻 翏
僈	亻 曼
佥	人 一 小 一
僊	亻 覀 大 己
僌	亻 車 攵
僎	亻 巽
像	亻 象
僐	亻 善
侨	亻 乔
僒	亻 窘
僔	亻 尊
仆	亻 卜
僖	亻 喜
僘	亻 敞
僙	亻 黃
僚	亻 尞
僛	亻 欺
僜	亻 登
僝	亻 孱
伪	亻 为
僠	亻 番
僡	亻 惠
僢	亻 舜
僣	亻 替
侥	亻 尧
僦	亻 就
僧	亻 曽
偾	亻 贲
僪	亻 矞
僬	亻 焦
僭	亻 朁
僮	亻 童
僯	亻 粦
僰	棘 人
雇	户 隹
僳	亻 粟
僵	亻 畺
僷	亻 葉
僸	亻 禁
价	亻 介
僺	亻 喿
僻	亻 辟
僼	亻 豐
僽	亻 愁
僿	亻 塞
仪	亻 义
儁	亻 雋
侬	亻 农
儃	亻 亶
亿	亻 乙
儆	亻 敬
儇	亻 睘
侩	亻 会
俭	亻 佥
儊	亻 楚
儋	亻 詹
儌	亻 敫
傻	亻 囟 儿 夂
傤	亻 载
傧	亻 宾
儒	亻 需
俦	亻 寿
侪	亻 齐
儗	亻 疑
尽	尺 冫
儙	亻 遣
儛	亻 舞
偿	亻 尝
儠	亻 巤
儡	亻 畾
儤	亻 暴
儦	亻 麃
优	亻 尤
儫	亻 豪
储	亻 诸
儳	亻 毚
儴	亻 襄
儵	攸 黑
儶	亻 巂
俪	亻 丽
傩	亻 难
傥	亻 党
俨	亻 严
儽	亻 纍
儾	亻 囊
兀	一 儿
允	厶 儿
兂	厂 尢 旡
元	二 儿
兄	口 儿
充	亠 允
兆	冰 儿 丶 丶
凶	凵 乂
先	丿 土 儿
光	小 兀
兑	丷 口 儿
克	十 口 儿
兑	丷 口 儿
免	刀 口 丨 儿
兔	刀 口 丨 儿 丶
兏	厂 上 儿
児	旧 儿
儿	丿 乚
兓	旡 旡
兔	刀 口 丨 儿 丶
兕	凹 儿
兖	亠 兊
兗	亠 兌
兘	元 台
兛	克 千
兜	匚 白 ㇆ 一 儿
兝	克 分
兞	克 毛
兟	先 先
兠	丬 白 匕 儿
兢	克 克
兣	克 厘
入	乁 丿
兦	丨 一 入
内	冂 人
全	人 王
两	一 冂 丨 人 人
俞	人 一 月 刂
八	丿 乁
公	八 厶
六	亠 八
兮	八 丂
共	十 丨 一 八
兲	王 八
兵	丘 八
其	甘 一 八
具	目 一 八
典	曲 八
兼	丷 一 聿 丨 丨 八
兾	丷 異
艺	艸 乙
冀	北 異
冂	丨 乙
冄	冂 二
圆	囗 员
冇	一 丿 冂
冉	冂 十 一
册	⺆ ⺆ 一
冋	冂 口
再	一 冂 十 一
冏	冂 八 口
冐	曰 月
冑	由 冂 二
冒	冂 二 目
冓	井 再
冔	冂 二 吁
冕	冂 二 勉
冖	丶 乛
冗	冖 几
冘	冖 丿 乚
冚	冖 山
冝	冖 且
冞	冖 米
冟	冖 皂
冠	冖 元 寸
冡	冖 一 豕
冢	冖 豖
冣	冖 取
冤	冖 兔
冥	冖 日 大
冦	冖 元 攴
冧	冖 林
冨	冖 畐
冩	冖 舄
幂	冖 日 大 巾
冫	丶 丿
冬	夂 冫
冭	大 冫
冮	冫 工
冰	冫 水
冱	冫 互
冴	冫 牙
冶	冫 台
冷	冫 令
冸	冫 半
冹	冫 犮
冺	冫 民
冼	冫 先
冽	冫 列
冾	冫 合
冿	冫 聿
凁	冫 束
凂	冫 免
凃	冫 余
凅	冫 固
准	冫 隹
凇	冫 松
净	冫 争
凊	冫 青
凋	冫 周
凌	冫 夌
冻	冫 东
凎	冫 金
凐	冰 垔
凓	冫 栗
凕	冫 冥
凗	冫 崔
凘	冫 斯
凚	冫 禁
凛	冫 禀
凝	冫 疑
凞	冫 熙
几	丿 乙
凡	几 丶
凢	丶 几
凣	丶 几
凥	尸 几
处	夂 卜
凧	几 巾
凨	几 云
凬	几 一 日
凮	几 百
凰	几 皇
凯	岂 几
凲	几 兼
凳	登 几
凵	丨 一 丨
凶	凵 乂
凷	凵 土
出	山 凵
凼	凵 水
函	凵 氶
凾	凵 亟
刀	㇆ 丿
刂	丨 亅
刃	刀 丶
刄	刀 乀
刅	刀 八
分	八 刀
切	七 刀
刈	乂 刂
刉	乞 刂
刊	干 刂
刋	千 刂
刌	寸 刂
刍	刀 彐
刎	勿 刂
刏	气 刂
刐	丹 刂
刑	开 刂
划	戈 刂
刓	元 刂
刔	夬 刂
刕	刀 刀 刀
刖	月 刂
列	歹 刂
刜	弗 刂
初	衤 刀
刞	且 刂
刟	召 刂
刡	民 刂
刢	令 刂
刣	台 刂
判	半 刂
别	另 刂
劫	去 力
劫	去 力
刨	包 刂
利	禾 刂
删	册 刂
刮	舌 刂
刯	亘 刂
到	至 刂
刱	井 刅
刲	圭 刂
刳	夸 刂
剁	朵 刂
刵	耳 刂
制	丿 二 巾 刂
刷	尸 巾 刂
券	𠔉 刀
刺	朿 刂
刻	亥 刂
劫	去 力
剁	朵 刂
剃	弟 刂
刭	圣 刂
剅	豆 刂
剆	艮 刂
则	贝 刂
剈	肙 刂
剉	坐 刂
削	肖 刂
克	十 口 儿
剌	束 刂
前	丷 一 月 刂
刹	杀 刂
剏	并 刃
剒	昔 刂
剓	禾 勹 丿 刀
剔	易 刂
剕	非 刂
剖	咅 刂
刬	戋 刂
剘	其 刂
剙	并 刅
剚	事 刂
刚	冈 刂
剜	宛 刂
剥	录 刂
剞	奇 刂
剟	叕 刂
剠	京 刂
剡	炎 刂
剢	豖 刂
剑	佥 刂
剂	齐 刂
剦	奄 刂
剨	砉 刂
剩	乘 刂
剪	前 刀
剫	度 刂
剬	耑 刂
剭	屋 刂
剐	呙 刂
副	畐 刂
剩	乘 刂
剑	佥 刂
割	害 刂
剳	荅 刂
剀	岂 刂
创	仓 刂
剶	彖 刂
剹	翏 刂
剺	未 攵 厂 刀
剻	崩 刂
剽	票 刂
剿	巢 刂
劀	矞 刂
劁	焦 刂
劂	厥 刂
划	戈 刂
劄	答 刂
劅	蜀 刂
劆	廉 刂
剧	居 刂
劈	辟 刀
刘	文 刂
刽	会 刂
劋	喿 刂
刿	岁 刂
剑	佥 刂
剑	佥 刂
劐	蒦 刂
剂	齐 刂
剑	佥 刂
劓	鼻 刂
剑	佥 刂
劖	毚 刂
劘	靡 刂
劙	蠡 刂
力	丿 ㇆
劜	力 乚
功	工 力
加	力 口
劣	少 力
劤	斤 力
劥	亢 力
劦	力 力 力
劧	手 力
助	且 力
努	奴 力
劫	去 力
劬	句 力
劭	召 力
劮	失 力
劯	石 力
劰	白 力
劳	艸 冖 力
劵	𠔉 力
劶	后 力
劷	羊 力
劸	圭 力
効	交 力
劺	牟 力
劻	匡 力
劼	吉 力
劽	列 力
劾	亥 力
勀	克 力
劲	圣 力
勂	告 力
勃	孛 力
勄	每 力
勅	束 力
勆	良 力
勇	甬 力
勈	甬 力
勉	免 力
勊	克 力
勌	卷 力
勍	京 力
勎	坴 力
勏	咅 力
勐	孟 力
勒	革 力
勓	皆 力
勔	面 力
动	云 力
勖	冒 力
勗	日 助
勘	甚 力
务	夂 力
勋	员 力
勜	翁 力
胜	月 生
劳	艹 冖 力
募	莫 力
勠	翏 力
勡	票 力
势	执 力 勢
勤	堇 力
勥	强 力
勦	巢 力
劝	又 力
勨	象 力
勚	贳 力
勫	番 力
勬	絭 力
勭	童 力
勮	豦 力
勯	亶 力
勰	劦 思
劢	万 力
勲	動 灬
勳	熏 力
励	厉 力
勶	徹 力
勷	襄 力
劝	又 力
勹	丿 ㇆
勺	勹 丶
匀	勹 冫
勼	勹 九
勽	勹 人
勾	勹 厶
勿	勹 丿 丿
匃	勹 亾
匄	勹 亡
包	勹 己
匆	勿 丶
匈	勹 凶
匉	勹 平
匊	勹 米
匋	勹 缶
匌	勹 合
匍	勹 甫
匎	勹 奄
匏	夸 包
匐	勹 畐
匑	勹 躬
匒	勹 荅
匓	勹 艮 殳
匔	勹 身 吕
匕	乚 丿
化	亻 匕
北	丬 匕
匙	是 匕
匛	匚 久
匜	匚 也
匝	匚 巾
匞	匚 工
匟	匚 亢
匠	匚 斤
匡	匚 王
匢	匚 勿
匣	匚 甲
匤	匚 玉
匥	匚 弁
匧	匚 夾
匩	匡 山
匪	匚 非
匫	匚 曶
匬	匚 俞
匦	匚 轨
汇	氵 匚
匮	匚 贵
匲	匚 大 品
匴	匚 算
匷	匚 瞿
匹	匚 儿
匼	匸 合
匽	匸 妟
匾	匚 扁
匿	匚 若
区	匚 乂
十	一 丨
卂	乁 十
千	丿 十
卄	一 丨 丨
卅	川 一
卆	九 十
升	丿 十 丿
午	丿 干
卉	十 廾
半	八 一 十
卋	十 廿
卌	川 丨 一
卑	丶 田 丿 十
卒	亠 人 十
卓	卜 日 十
协	十 办
南	十 冂 丫 二
単	小 日 十
卙	甚 十
博	十 甫 寸
卜	丨 丶
卝	一 丨 丨 一
卞	丶 下
卟	口 卜
占	卜 口
卡	上 下
卣	卜 囙
卥	卜 囪
卦	圭 卜
卩	丨 ㇆
卪	卩 丶
卬	匚 卩
卭	工 卩
卮	厂 一 卩
卯	匸 丿 卩
印	匸 一 卩
危	刀 厂 卩
卲	召 卩
即	艮 卩
卵	匸 丿 丶 卪
卶	多 卩
卷	𠔉 㔾
卸	午 止 卩
卹	血 卩
卺	丞 㔾
却	去 卩
卼	兀 危
即	艮 卩
卾	咢 卩
卿	匸 丿 即
厀	桼 卩
厃	刀 厂
厄	厂 㔾
厇	厂 乇
厈	厂 干
厊	厂 牙
厎	厂 氐
厏	厂 乍
厒	厂 缶
厓	厂 圭
厔	厂 至
厖	厂 尨
厗	厂 辛
厍	厂 车
厚	厂 日 子
厅	厂 丁
厜	厂 垂
厝	厂 昔
厞	厂 非
原	厂 泉
厡	厂 泉
厤	厂 秝
厥	厂 欮
厧	厂 真
厪	厂 堇
厫	厂 敖
厬	厂 晷
厌	厂 犬
厯	厂 林 乚 丶 丶
厰	厂 敞
厉	厂 万
严	亚 丿
厣	厂 犬 甲
厵	原 原 原
厶	𠃊 丶
厷	一 丿 厶
厸	厶 厶
厹	九 厶
厺	大 厶
去	土 厶
厽	厶 厶 厶
厾	乁 去
叀	一 由 厶
参	厶 大 彡
叁	厶 大 三
叅	厽 人 小 丶
叉	又 丶
及	乃 乀
友	一 丿 又
反	厂 又
収	丩 又
叏	乛 支
叐	丿 友
叒	又 又 又
叓	支 口
叔	尗 又
叕	又 又 又 又
取	耳 又
受	爫 冖 又
叚	尸 二 又
叛	半 反
叜	灾 又
叝	去 及
叞	尸 示 又
叟	臼 丨 又
叡	睿 又
丛	从 一
口	冂 一
古	十 口
句	勹 口
另	口 力
叧	口 刀
叨	口 刀
叩	口 卩
只	口 八
叫	口 丩
召	刀 口
叭	口 八
叮	口 丁
可	丁 口
台	厶 口
叱	口 匕
史	口 乂
右	一 丿 口
叴	九 口
叵	匚 口
司	㇆ 一 口
叺	口 入
叻	口 力
叼	口 刁
叿	口 工
吀	口 千
吁	口 于
吂	亡 口
吃	口 乞
各	夂 口
吅	口 口
吆	口 幺
吇	口 子
合	人 一 口
吉	士 口
吋	口 寸
同	冂 一 口
名	夕 口
后	厂 一 口
吏	一 口 丿 乀
吐	口 土
向	丶 冂 口
咤	口 宅 吒
吓	口 下
吔	口 也
吖	口 丫
吘	口 午
吙	口 火
吚	口 尹
君	尹 口
吜	口 丑
吝	文 口
吞	天 口
吟	口 今
吠	口 犬
吡	口 比
吢	心 口
吣	口 心
吤	口 介
吥	口 不
否	不 口
吧	口 巴
吩	口 分
吪	口 化
含	今 口
吭	口 亢
吮	口 允
吰	口 厷
吱	口 支
吲	口 引
吴	口 天
吵	口 少
呐	口 内
吷	口 夬
吸	口 及
吹	口 欠
吺	口 殳
吻	口 勿
吼	口 孔
吽	口 牛
吾	五 口
吿	牛 口
呀	口 牙
呁	口 勻
吕	口 口
呃	口 厄
呄	乃 古
呅	口 文
呆	口 木
呇	水 口
呈	口 王
吴	口 天
告	牛 口
呋	口 夫
呌	口 斗
呍	口 云
呎	口 尺
呏	口 升
吞	天 口
呔	口 太
呝	口 戹
呞	口 司
呟	口 玄
呠	口 本
呡	口 民
呢	口 尼
呤	口 令
呥	口 冉
呦	口 幼
呧	口 氐
周	冂 土 口
呩	口 示
呪	口 兄
呫	口 占
呬	口 四
呭	口 世
呮	口 只
呯	口 平
呰	此 口
呱	口 瓜
呲	口 此
味	口 未
呴	口 句
呵	口 可
呶	口 奴
呷	口 甲
呸	口 不 一
呹	口 失
呺	口 号
呻	口 申
呼	口 乎
命	人 一 叩
呾	口 旦
呿	口 去
咀	口 且
咂	口 匝
咃	口 他
咄	口 出
咅	立 口
咆	口 包
咇	口 必
咈	口 弗
咉	口 央
咊	口 禾
咋	口 乍
和	禾 口
咍	口 台
咎	夂 人 口
咐	口 付
咑	口 打
咒	口 口 几
咓	口 瓦
咔	口 卡
咕	口 古
咖	口 加
咗	口 左
咘	口 布
咚	口 冬
咞	口 开
咟	口 百
咠	口 耳
咡	口 耳
咢	口 口 亏
咣	口 光
咤	口 宅
咥	口 至
咦	口 夷
咧	口 列
咨	次 口
咩	口 羊
咪	口 米
咫	尺 只
咬	口 交
咭	口 吉
咮	口 朱
咯	口 各
咰	口 旬
咱	口 自
咲	口 关
咳	口 亥
咴	口 灰
咵	口 夸
咶	口 舌
咷	口 兆
咸	戊 一 口
咹	口 安
咺	口 亘
咻	口 休
呙	口 内
咽	口 因
咾	口 老
咿	口 伊
哀	衣 口
品	口 口 口
哂	口 西
哃	口 同
哄	口 共
哅	口 匈
哆	口 多
哇	口 土 土
哈	口 合
哉	土 戈 口
哊	口 有
哋	口 地
哌	口 厂 氏
响	口 向
哎	口 艾
哏	口 艮
哐	口 匡
哚	口 朵
哞	口 牟
哠	口 告
员	口 贝
哢	口 弄
哣	口 豆
哤	口 尨
哥	可 可
哦	口 我
哧	口 赤
哨	口 肖
哩	口 里
哪	口 那
哫	口 足
哬	口 何
哭	口 口 犬
哮	口 孝
哰	口 牢
哱	口 孛
哲	折 口
哳	口 折
哴	口 良
哵	口 別
哶	口 羊
哷	口 寽
哸	口 妥
哹	口 孚
哺	口 甫
哻	口 旱
哼	口 享
哽	口 更
哾	口 兑
哿	加 可
唀	口 秀
唁	口 言
唂	口 谷
唃	口 角
呗	口 贝
唅	口 含
唆	口 夋
唇	口 辰
唈	口 邑
唉	口 矣
唋	口 余
唌	口 延
唍	口 完
唎	口 利
唏	口 希
唐	广 聿 口
唑	口 坐
唒	口 酉
唔	口 吾
唕	口 早
哑	口 亚
唗	口 走
唘	石 又 口
唙	口 狄
唚	口 彐 冖 又
唞	口 抖
唣	口 皂
唥	口 冷
唦	口 沙
唧	口 即
唨	口 阻
唩	口 委
唪	口 奉
唫	口 金
唬	口 虎
唭	口 其
售	隹 口
唯	口 隹
唰	口 刷
唱	口 昌
唲	口 兒
唳	口 戻
唴	口 羌
唵	口 奄
唶	口 昔
唷	口 育
念	今 心
唹	口 於
唺	口 典
唼	口 妾
唽	口 析
唾	口 垂
唿	口 忽
啀	口 厓
啁	口 周
啂	口 乳
啃	口 肯
啄	口 豖
啅	口 卓
商	亠 丷 冏
啇	亠 丷 冂 古
啈	口 幸
啉	口 林
啊	口 阿
啋	口 采
啌	口 空
啍	口 享
啎	午 吾
问	门 口
啐	口 卒
啑	口 疌
啒	口 屈
启	户 口
啔	户 戈 口
啕	口 匋
啖	口 炎
啗	口 陷
啘	口 宛
啙	此 口 口
啚	口 亠 回
啛	口 妻
啜	口 叕
啝	口 和
哑	口 亚
启	户 口
啠	斤 斤 口
啡	口 非
唡	口 两
啣	口 卸
啤	口 卑
啥	口 舍
啦	口 拉
啨	口 青
啩	口 卦
啪	口 拍
啫	口 者
啱	口 岩
啲	口 的
啳	口 卷
啵	口 波
啶	口 定
啷	口 郎
啻	帝 口
啼	口 帝
啽	口 弇
啾	口 秋
啿	口 甚
喀	口 客
喁	口 禺
喂	口 畏
喃	口 南
善	羊 丷 一 口
喅	口 昱
哲	折 口
喇	口 剌
喈	口 皆
喉	口 侯
喊	口 咸
喋	口 世 木
喌	口 口 州
喍	口 柴
㖞	口 呙
喏	口 若
喐	口 郁
喑	口 音
喒	口 昝
喓	口 要
喔	口 屋
喕	口 面
喖	口 枯
喘	口 山 而
喙	口 彖
唤	口 奂
喛	口 爰
喜	士 口 丷 一 口
喝	口 曷
唧	口 即
喟	口 胃
喠	口 重
喢	口 臿
喣	呴 灬
喤	口 皇
喥	口 度
喦	品 山
喧	口 宣
喨	口 亮
喩	口 俞
喫	口 契
乔	夭 丿 丨
喭	口 彦
单	丷 甲 一
喯	口 奔
喰	口 食
喱	口 厘
哟	口 约 喲
喳	口 查
喴	口 威
喵	口 苗
营	艸 冖 吕
喹	口 奎
喻	口 俞
喼	口 急
喿	口 口 口 木
嗀	士 冖 一 口 殳
嗁	口 虒
嗃	口 高
嗄	口 夏
嗅	口 臭
呛	口 仓
啬	土 丷 回
嗈	口 邕
嗉	口 素
唝	口 贡
嗋	口 脅
嗌	口 益
嗍	口 朔
吗	口 马
嗏	口 茶
嗐	口 害
嗑	口 去 皿
嗒	口 荅
嗓	口 桑
嗔	口 真
嗕	口 辱
嗖	口 叟
嗗	口 骨
嗘	口 奚
嗙	口 旁
呜	口 乌
嗛	口 兼
嗜	口 老 日
嗝	口 鬲
嗞	口 兹
嗟	口 差
嗠	孚 各
嗡	口 翁
嗢	口 昷
嗣	口 冊 司
嗤	口 蚩
嗥	口 皋
嗦	口 索
嗨	口 海
唢	口 小 贝
嗪	口 秦
嗬	口 荷
嗮	口 晒
嗯	口 恩
嗱	口 拿
嗲	口 爹
嗵	口 通
哔	口 毕
嗷	口 敖
嗸	敖 口
嗺	口 崔
嗻	口 庶
嗼	口 莫
嗽	口 束 欠
嗾	口 族
嘀	口 啇
嘁	口 戚
嘂	口 口 丩 口 口
嘃	口 庸
嘅	口 既
叹	口 又
嘈	口 曹
嘉	士 口 丷 一 加
嘊	口 崖
嘋	口 教
嘌	口 票
喽	口 娄
嘎	口 戛
嘏	古 叚
嘐	口 翏
嘑	口 虖
嘒	口 彗
啯	口 国
呕	口 区
嘕	口 焉
啧	口 责
尝	小 冖 云
嘙	口 婆
嘚	口 得
嘛	口 麻
唛	口 麦
嘝	口 斛
嘞	口 勒
嘟	口 都
嘠	口 百 冖 戈
嘡	口 堂
嘢	口 野
嘣	口 朋
嘥	口 徙
嘦	只 要
嘧	口 密
啸	口 肃
哗	口 华
嘫	口 然
嘬	口 最
嘭	口 彭
唠	口 劳
啸	口 肃
叽	口 几
嘲	口 朝
嘴	口 觜
哓	口 尧
嘶	口 斯
嘷	口 臯
呒	口 无
嘹	口 尞
嘻	口 喜
嘼	口 口 田 一 口
啴	口 单
嘾	口 覃
嘿	口 黑
噀	口 巽
恶	亚 心
噂	口 尊
噃	口 番
噄	口 潔
噆	口 朁
噇	口 童
噈	口 就
噉	口 敢
噊	口 矞
噋	口 敦
噌	口 曾
噍	口 焦
噎	口 壹
噏	口 翕
噐	口 口 工 口 口
噑	口 皐
噒	口 粦
嘘	口 虚
噔	口 登
噖	口 琴
噗	口 菐
噘	口 厥
噙	口 禽
啮	口 齿
咝	口 丝
噟	广 人 隹 口
哒	口 达
噡	口 詹
噢	口 奥
噣	口 蜀
噤	口 禁
哝	口 农
哕	口 岁
器	口 口 大 口 口
噩	一 口 口 一 口 口 一 丨
噪	口 品 木
噫	口 意
噬	口 筮
噭	口 敫
噮	口 睘
嗳	口 爱
噰	口 雍
噱	口 豦
哙	口 会
噳	口 虞
喷	口 贲
噵	道 口
噶	口 葛
噷	口 歆
吨	口 屯
当	小 彐
噻	口 塞
噼	口 辟
噽	喜 丕
噾	口 窨
噿	口 翠
咛	口 宁
嚁	口 翟
嚃	口 遝
嚄	口 蒦
嚅	口 需
嚆	口 蒿
吓	口 下
嚊	口 鼻
哜	口 齐
嚎	口 豪
嚏	口 疐
尝	小 冖 云
嚓	口 察
嚏	口 疐
噜	口 鲁
嚖	口 慧
嚗	口 暴
嚘	口 憂
啮	口 齿
嚚	口 口 臣 口 口
嚜	口 墨
嚞	吉 吉 吉
嚟	口 黎
嚢	十 口 冖 八 井 一 
嚤	口 摩
咽	口 因
呖	口 历
咙	口 龙
嚭	喜 否
向	丶 冂 口
嚯	口 霍
嚰	口 磨
亸	享 单
喾	小 冖 告
严	亚 丿
嚵	口 毚
嘤	口 婴
嚷	口 襄
嚹	口 罅
嚺	口 网 遂
嚼	口 爵
嚾	口 雚
啭	口 转
嗫	口 聂
嚣	口 口 页 口 口
囃	口 雜
冁	单 展
呓	口 艺
啰	口 罗
囊	一 口 丨 冂 口 口 井 一 
苏	艸 办
囍	士 口 丷 一 口 士 口 丷 一 口
囏	革 大 喜
嘱	口 属
啮	口 齿
囔	口 囊
囗	丨 乛  一
回	囗 口
囚	囗 人
四	囗 儿
囜	囗 厶
囝	囗 子
回	囗 口
囟	丶 囗 乂
因	囗 大
囡	囗 女
団	囗 寸
囤	囗 屯
囥	囗 亢
囦	囗 水
囧	囗 儿 冂
囨	囗 不
囩	囗 云
囪	丶 囗 丿 丿 丶
囫	囗 勿
回	囗 口
囮	囗 化
囯	囗 王
困	囗 木
囱	丶 囗 夕
围	囗 韦
图	囗 冬
囶	囗 八 土
囷	囗 禾
囸	囗 正
囹	囗 令
固	囗 古
囻	囗 民
囼	囗 台
囿	囗 有
圀	囗 儿 方
圁	囗 言
圂	囗 豕
圃	囗 甫
圄	囗 吾
圅	龴 囗 丷 干
囵	囗 仑
圈	囗 卷
圉	囗 幸
圊	囗 青
国	囗 玉
圌	囗 耑
围	囗 韦
圈	囗 卷
圐	囗 网 方
圑	囗 尃
园	囗 元
圆	囗 员
圔	囗 盍
图	囗 冬
圗	囗 厶 面
团	囗 才
圙	囗 八 面
圜	囗 睘
土	十 一
圠	土 乚
圡	土 丶
圢	土 丁
圤	土 卜
圥	土 儿
压	厂 圡
在	一 亻 土
圩	土 于
圪	土 乞
圫	土 乇
圬	土 亏
圭	土 土
圮	土 己
圯	土 巳
地	土 也
圱	千 土
圲	土 千
圳	土 川
圴	土 勺
圵	土 上
圶	大 土
圻	土 斤
圼	日 土
圽	土 勿
圾	土 及
圿	土 介
址	土 止
坁	土 氏
坂	土 反
坃	土 元
坄	土 殳
坅	土 今
坆	土 攵
均	土 匀
坈	土 冗
坉	土 屯
坊	土 方
坋	土 分
坌	土 分
坍	土 丹
坎	土 欠
坐	人 人 土
坑	土 亢
坒	比 土
坓	井 土
坔	土 水
坕	爪 土
坖	土 元
坘	土 互
坙	一 巛 土
坡	土 皮
坢	土 半
坣	丷 宀 土
坤	土 申
坥	土 且
坦	土 旦
坧	土 石
坨	土 它
坩	土 甘
坪	土 平
坫	土 占
坬	土 瓜
坭	土 尼
坮	土 台
坯	土 丕
坰	土 冋
坱	土 央
坲	土 弗
坳	土 幼
坴	土 八 土
坵	土 丘
坶	土 母
坷	土 可
坸	土 句
坹	土 穴
坺	土 犮
坻	土 氐
坼	土 斥
坽	土 令
坾	土 宁
坿	土 付
垀	土 乎
垁	土 矢
垂	丿 二 土 丨 丨
垃	土 立
垇	土 凹
垉	土 包
型	刑 土
垌	土 同
垍	土 自
垎	土 各
垏	土 聿
垐	次 土
垑	土 多
垓	土 亥
垔	覀 土
垕	后 土
垖	土 户 乛 一
垗	土 兆
垘	土 伏
垙	土 光
垚	土 土 土
垛	土 朵
垛	土 朵
垝	土 危
垞	土 宅
垟	土 羊
垠	土 艮
垡	伐 土
垢	土 后
垣	土 亘
垤	土 至
垥	土 合
垧	土 向
垨	土 守
垬	土 共
垮	土 夸
垵	土 安
垶	土 辛
垸	土 完
垹	土 邦
垺	土 孚
坝	土 贝
垼	役 土
垽	沂 土
垾	土 旱
垿	土 序
埀	乖 土
埁	土 岑
埂	土 更
埃	土 矣
埄	土 夆
埅	防 土
埆	土 角
埇	土 甬
埈	土 夋
埊	山 水 土
埋	土 里
埌	土 良
埍	土 肙
城	土 成
埏	土 延
埐	土 彐 冖 又
埑	折 土
埒	土 寽
埓	土 寽
埔	土 甫
埕	土 呈
埗	土 步
埛	土 冏
埜	林 土
埝	土 念
埞	土 定
域	土 或
埠	土 阜
垭	土 亚
埢	土 卷
埣	土 卒
埤	土 卑
埥	土 青
埦	土 宛
埧	土 具
埪	土 空
埫	土 尚
埭	土 隶
埮	土 炎
埯	土 奄
埰	土 采
埱	土 叔
埲	土 奉
埳	土 臽
埴	土 直
埵	土 垂
埶	坴 丸
执	扌 丸
埸	土 易
培	土 咅
基	其 土
埻	土 享
埼	土 奇
埽	土 帚
埾	取 土
埿	泥 土
堀	土 屈
堁	土 果
堂	尚 土
昆	日 比
堄	土 兒
坚	丨 丨 又 土
堆	土 隹
堇	廿 口 丰
堉	土 育
垩	亚 土
堋	土 朋
堌	土 固
堍	土 兔
堎	土 夌
堐	土 厓
堓	土 岸
垴	土 亠 乂 凵
堗	土 突
堘	土 𠔉 土
堙	土 西 土
堛	土 畐
堜	土 柬
埚	土 呙
堞	土 枼
堟	土 彖
堠	土 侯
堡	保 土
堢	土 保
堣	土 禺
堤	土 是
堥	敄 土
堦	土 皆
堧	土 耎
堨	土 曷
堩	土 恆
堪	土 甚
堫	土 凶 八 夂
堬	土 俞
堭	土 皇
堮	土 咢
堰	土 匽
报	扌 卩 又
堲	即 土
堳	土 眉
场	土 弓 丿 丿
堵	土 者
堶	土 左 月
堷	土 音
堹	土 重
堺	土 界
堻	津 土
堼	封 土
堽	土 罡
堾	土 春
堿	土 咸
塂	土 巷
塃	土 荒
塄	土 罒 方
塅	土 段
塇	土 宣
塈	既 土
塉	土 脊
块	土 夬
茔	艸 冖 土
塌	土 曰 羽
塍	月 丷 夫 土
塎	土 容
垲	土 岂
塐	土 素
塑	朔 土
埘	土 时
塓	土 冥
塔	土 荅
塕	土 翁
塖	土 乘
涂	氵 余 土 塗
塘	土 唐
塙	土 高
塚	土 冢
塛	土 栗
塜	土 冡
塝	土 旁
塞	宀 井 大 土
塟	艸 死 土
塠	土 追
填	土 真
坞	土 乌
塣	浧 土
埙	土 员
塥	土 鬲
塧	土 益
塨	土 恭
盐	土 卜 皿
塪	土 舀
填	土 真
塬	土 原
塭	土 昷
塮	土 射
塯	土 留
塱	朗 土
场	土 弓 丿 丿
塳	土 逢
塴	土 朋
尘	小 土
塶	土 鹿
堑	斩 土
塺	麻 土
塻	土 莫
塽	土 爽
塾	孰 土
墀	土 犀
墁	土 曼
墂	土 票
境	土 竟
墄	土 戚
墅	野 土
墇	土 章
墈	土 勘
墉	土 庸
垫	执 土
墌	土 庶
墍	旣 土
墎	土 郭
墐	土 堇
墑	土 啇
墒	土 商
墓	莫 土
墔	土 崔
墕	土 焉
墖	土 畣
增	土 曾
墘	土 乾
墚	土 梁
坠	队 土
增	土 曾
墟	土 虚
墡	土 善
墥	土 童
墦	土 番
墨	黑 土
墩	土 敦
墪	敦 土
墫	土 尊
墬	阝 彖 土
墭	土 盛
堕	陏 土
墯	惰 土
墰	土 覃
墱	土 登
坟	土 文
墴	土 黄
墺	土 奧
墙	土 啬
墽	土 敫
垦	艮 土
壀	土 辟
壁	辟 土
壂	殿 土
壃	土 畺
壄	楙 土
壅	雍 土
壆	臼 爻 冖 土
坛	土 云
壉	土 豦
坏	土 不
垱	土 当
壌	土 衣 八 井 一
壎	土 熏
壑	卜 冖 一 谷 又 土
壒	土 蓋
压	厂 土 丶
壕	土 豪
壖	土 需
垒	厶 厶 厶 土
圹	土 广
垆	土 卢
壛	土 閻
坛	土 云
坏	土 不
垄	土 龙
垅	土 龙
壡	睿 圣
坜	土 历
壤	土 襄
壦	土 雚
壨	田 田 田 田 土
坝	土 贝
士	十 一
壬	丿 士
壮	丬 士
壱	士 冖 匕
卖	十 买
壴	士 口 丷 一
壵	士 士 士
壶	士 冖 业
壹	士 冖 豆
壶	士 冖 业
壻	土 胥
壸	士 冖 亚
寿	丰 寸
壾	壴 巨
壿	土 尊
夀	韦 口 一 吋
夁	士 罒 固
夂	丿 丿 乀
夅	夂 匸 丨
夆	夂 丰
变	亦 又
夋	厶 八 夂
夌	土 八 夂
夎	坐 夂
夏	一 自 夂
夐	刀 罓 目 夂
夒	一 自 止 已 八 夂
夓	夏 夂
夔	丷 一 止 自 卩 夂
夕	丿 丿 丶
外	夕 卜
夗	夕 㔾
夘	夕 卩
夙	几 歹
多	夕 夕
夛	彐 夕
夜	亠 亻 夕 丶
夝	夕 生
够	句 多
夡	多 吉
梦	木 木 夕
夣	亠 厶 罒 冖 夕
夤	夕 寅
伙	亻 火
夥	果 多
夦	甚 多
大	人 一
夨	𠃊 大
天	一 大
太	大 丶
夫	二 人
夬	乛 大
夭	丿 大
央	冂 大
夯	大 力
夰	大 丿 丨
失	丶 夫
夲	大 十
夳	大 二
夵	大 小
夶	大 大
夷	一 弓 人
夸	大 亏
夼	大 川
夽	大 云
夹	一 丷 大
夿	大 巴
奀	不 大
奃	大 氐
奄	大 电
奅	大 卯
奆	大 巨
奇	大 可
奈	大 示
奉	龹 一 十
奊	丨 一 圭 大
奌	占 大
奎	大 土 土
奏	龹 夭
奂	刀 冂 大
契	丰 刀 大
奒	大 亥
奓	大 多
奔	大 卉
奕	亦 大
套	大 镸
奘	壯 大
奙	厶 大 电
奚	爫 幺 大
奛	大 明
奜	非 大
奝	大 周
奞	大 隹
奟	大 朋
奠	酋 大
奡	一 自 夰
奢	大 者
奣	天 明
奤	大 面
奦	務 大
奥	丶 冂 米 大
奖	丬 夕 大
奁	大 区
夺	大 寸
奭	大 百 百
奋	大 田
奯	大 歲
奰	罒 罒 罒 大
女	𠃊 一 丿
奴	女 又
奵	女 丁
奶	女 乃
奷	女 千
奸	女 干
她	女 也
奺	女 久
奻	女 女
奼	女 乇
好	女 子
奾	女 山
奿	丸 女
妀	己 女
妁	女 勺
如	女 口
妃	女 己
妄	亡 女
妅	女 工
妉	女 冘
妊	女 壬
妋	女 夫
妌	女 井
妍	女 开
妎	女 介
妏	女 文
妐	女 公
妑	女 巴
妒	女 户
妓	女 支
妔	女 亢
妕	女 中
妖	女 夭
妗	女 今
妘	女 云
妙	女 少
妚	女 不
妜	女 夬
妆	丬 女
妞	女 丑
妟	日 女
妠	女 內
妡	女 斤
妢	女 分
妣	女 比
妤	女 予
妥	爫 女
妦	女 丰
妧	女 元
妨	女 方
妬	女 石
妭	女 犮
妮	女 尼
妯	女 由
妰	女 乍
妱	女 召
妲	女 旦
你	亻 尔
妴	夗 女
妵	女 主
妶	女 玄
妷	女 失
妸	女 可
妹	女 未
妺	女 末
妻	一 肀 女
妼	女 必
妽	女 申
妾	立 女
妿	加 女
姀	女 禾
姁	女 句
姂	女 乏
姃	女 正
姄	女 民
姅	女 半
姆	女 母
姇	付 女
姈	女 令
姉	女 市
姊	女 丿 ㇉ 丨 丿
始	女 台
姌	女 冉
姗	女 册
姎	女 央
姏	女 甘
姐	女 且
姑	女 古
姒	女 以
姓	女 生
委	禾 女
姕	此 女
姖	女 巨
姘	女 并
姙	女 任
姚	女 兆
姛	女 同
姜	羊 女
姝	女 朱
姞	女 吉
姟	女 亥
姠	女 向
姡	女 舌
姢	女 厶 月
姣	女 交
姤	女 后
姥	女 老
奸	女 干
姧	女 女 干
姨	女 夷
姩	女 年
姪	女 至
姫	女 臣
姬	女 匸 丨 口 丨
姭	劦 女
姮	女 亘
姯	女 光
姰	女 旬
姱	女 夸
姲	女 安
姳	女 名
姴	列 女
姵	女 几 帀
姶	女 合
姷	女 有
姸	女 幵
姹	女 宅
姺	女 先
姻	女 因
姼	女 多
姽	女 危
姾	女 全
姿	次 女
娀	女 戎
威	戊 一 女
娂	女 共
娃	女 土 土
娉	女 甹
娋	女 肖
娌	女 里
娍	女 成
娎	折 女
娏	女 尨
娑	沙 女
娒	女 每
娓	女 尾
娔	女 克
娕	女 束
娖	女 足
娗	女 廷
娘	女 良
娚	女 男
娱	女 吴
娜	女 那
娝	女 否
娞	女 妥
娟	女 口 月
娠	女 辰
娡	女 志
娢	女 含
娣	女 弟
娥	女 我
娦	女 兵
娧	女 兑
娨	女 旱
娩	女 免
娪	女 吾
娫	女 延
娬	女 武
娭	女 矣
娮	女 言
娱	女 吴
娰	女 似
娵	女 取
娶	取 女
娷	女 垂
娸	女 其
娹	女 弦
娺	女 叕
娼	女 昌
娽	女 录
娾	女 厓
娿	阿 女
婀	女 阿
娄	米 女
婂	女 帛
婃	女 宗
婄	女 咅
婅	女 匊
婆	波 女
婇	女 采
婈	女 夌
婉	女 宛
婊	女 表
婋	女 虎
婌	女 叔
婍	女 奇
婎	女 隹
婏	女 兔
婐	女 果
婑	女 委
婒	女 炎
婓	非 女
婕	女 疌
婖	女 忝
婗	女 兒
婘	女 卷
婙	女 争
婚	女 昏
婛	女 京
婝	女 定
婞	女 幸
婟	女 固
婠	女 官
婢	女 卑
婣	女 片 一 爿
婤	女 周
婥	女 卓
妇	女 彐
婧	女 青
婩	女 岸
婪	木 木 女
婫	女 昆
婬	女 爫 壬
娅	女 亚
婯	丽 女
婰	女 典
婱	弦 女
婷	女 亭
婹	女 要
婺	敄 女
婻	女 南
婼	女 若
婽	女 叚
婾	女 俞
婿	女 胥
媀	女 禺
媂	女 帝
媃	女 柔
媄	女 美
媅	女 甚
媆	女 耎
媇	女 亲
媉	女 屋
媊	女 前
媋	女 春
媌	女 苗
媎	女 者
媏	女 耑
媐	巸 女
媑	女 重
媒	女 某
媓	女 皇
媔	女 面
媕	女 弇
媖	女 英
媗	女 宣
媙	女 威
媚	女 眉
媛	女 爰
媝	秋 女
媞	女 是
媟	女 枼
媠	女 左 月
媡	女 柬
媢	女 冒
媣	女 染
媤	女 思
媥	女 扁
媦	女 胃
娲	女 呙
媨	女 酋
媩	女 胡
媮	女 俞
妫	女 为
媲	女 囟 比
媳	女 息
媴	女 袁
媵	月 丷 夫 女
媶	女 茸
媷	女 辱
媸	女 蚩
媹	女 留
媺	女 彳 山 一 儿 攴
媻	般 女
媪	女 昷
妈	女 马
媾	女 冓
媿	女 鬼
嫀	女 秦
嫁	女 家
嫂	女 叟
嫃	女 真
嫄	女 原
嫅	女 差
嫆	女 容
嫇	女 冥
嫉	女 疾
嫊	女 素
嫋	女 弱
嫌	女 兼
嫍	女 舀
嫎	女 旁
嫏	女 郎
嫐	女 男 女
嫑	不 要
嫓	女 刀 内 比
嫕	女 悘
嫖	女 票
妪	女 区
嫘	女 累
嫙	女 旋
嫚	女 曼
嫛	殹 女
嫜	女 章
嫝	女 康
嫞	女 庸
嫟	女 匿
嫠	未 攵 厂 女
嫡	女 啇
嫣	女 焉
嫤	女 堇
嫦	女 常
嫨	女 革 大
嫩	女 敕
嫪	女 翏
嫫	女 莫
嫬	女 庶
嫭	女 虖
嫮	女 雩
嫯	敖 女
嫰	女 欶
嫳	敝 女
嫴	女 辜
妩	女 无
嫶	女 焦
嫷	女 隋
嫸	女 善
嫹	女 黃
娴	女 闲
娴	女 闲
嫼	女 墨
嫽	女 尞
嫾	女 粦
婳	女 画
妫	女 为
嬁	女 登
媭	须 女
嬅	女 華
嬆	女 翕
娆	女 尧
嬉	女 喜
嬊	廿 北 口 女
婵	女 单
娇	女 乔
嬍	女 彳 山 一 王 攵
嬎	女 免 生
嬏	女 番
嬑	女 意
嬓	女 敫
嬔	女 免 生
嬖	辟 女
嬗	女 亶
嬘	女 遂
嫱	女 啬
嬚	女 廉
嬛	女 睘
嬞	女 董
嬠	女 喿
嫒	女 爱
娘	女 良
嬷	女 麽
嬥	女 翟
嬨	女 慈
嫔	女 宾
嬬	女 需
婴	贝 贝 女
嬲	男 女 男
嬴	亡 口 月 女 凡
婶	女 审
嬺	女 慝
嬿	女 燕
孀	女 霜
孁	霝 女
孂	女 簋
娘	女 良
孅	女 韱
孉	女 雚
孊	女 靡
娈	亦 女
子	了 一
孑	了 丿
孒	了 一
孓	了 乀
孔	子 乙
孕	乃 子
孖	子 子
字	宀 子
存	一 亻 子
孚	爫 子
孛	十 冖 子
孜	子 攵
孝	耂 子
孞	子 心
孟	子 皿
孠	司 子
孡	子 台
孢	子 包
季	禾 子
孤	子 瓜
孥	奴 子
孨	子 子 子
孩	子 亥
孙	子 小
孬	不 好
孮	子 宗
孰	享 丸
孱	尸 子 子 子
孴	孨 日
孵	卵 孚
孳	兹 子
孷	未 攵 厂 子
学	小 冖 子
孹	辟 子
孺	子 需
孼	辥 子
孽	薛 子
孪	亦 子
宀	丶 冖
宂	宀 几
它	宀 匕
宄	宀 九
宅	宀 乇
宆	宀 弓
宇	宀 于
守	宀 寸
安	宀 女
宊	宀 犬
宋	宀 木
完	宀 元
宍	宀 六
宎	宀 夭
宏	宀 厷
宐	宀 彑
宑	宀 井
宒	宀 毛
宓	宀 必
宔	宀 主
宕	宀 石
宖	宀 弘
宗	宀 示
官	宀 㠯
宙	宀 由
定	宀 疋
宛	宀 夗
宜	宀 且
实	宀 头
客	宀 各
宣	宀 亘
室	宀 至
宥	宀 有
宦	宀 臣
宨	宀 兆
宩	宀 米
宬	宀 成
宭	宀 君
宫	宀 口 口
宯	宀 孝
宰	宀 辛
宱	宀 作
宲	宀 呆
害	宀 丰 口
宴	宀 妟
宵	宀 肖
家	宀 豕
宷	宀 釆
宸	宀 辰
容	宀 谷
宺	向 一 川
宻	宀 又 丷 山
宼	宀 元 女
宿	宀 亻 百
寀	宀 采
寁	宀 疌
寂	宀 叔
寃	宀 兔
寄	宀 奇
寅	宀 一 由 八
密	宓 山
寇	宀 元 攴
寈	宀 青
寉	宀 隹
寋	宀 井 大
富	宀 畐
寍	宀 心 皿
寎	宀 爿 丙
寏	宀 奐
寐	宀 爿 未
寑	宀 侵
寒	宀 井 大 冫
寓	宀 禺
寔	宀 是
寕	宀 一 丶 罒 丁
寖	宀 浸
寗	宓 冉
寘	宀 真
寙	宀 瓜 瓜
寚	宀 王 缶
宽	宀 艸 见
宁	宀 丁
寞	宀 莫
察	宀 祭
寡	宀 直 分
寝	宀 丬 彐 冖 又
寣	宀 爿 言
寤	宀 爿 吾
寥	宀 翏
实	宀 头
宁	宀 丁
寨	宀 井 大 木
审	宀 申
写	冖 与
宽	宀 艸 见
寭	宀 惠
寮	宀 尞
寯	宀 雋
寰	宀 睘
寱	宀 爿 臬
寲	宀 疑
宝	宀 玉
宠	宀 龙
宝	宀 玉
寷	宀 豐
寸	一 亅 丶
寺	土 寸
寽	爫 寸
对	又 寸
尀	叵 寸
封	圭 寸
专	二 丨 龴
尃	甫 寸
射	身 寸
尅	克 寸
将	丬 夕 寸
专	二 丨 龴
尉	尸 示 寸
尊	酋 寸
寻	彐 寸
尌	壴 寸
对	又 寸
导	巳 寸
小	八 亅
尐	小 乀
少	小 丿
尒	人 小
尓	丿 一 小
尕	乃 小
尖	小 大
尗	上 小
尚	小 冂 口
尚	小 冂 口
尛	小 小 小
尜	小 大 小
尞	昚 小
尟	是 少
尠	甚 少
尢	一 丿 乚
尣	八 儿
尤	一 丿 乚 丶
尥	尢 勺
尦	尣 勺
尨	尤 彡
尩	尣 王
尪	尢 王
尫	兀 王
尬	尢 介
尮	尢 朶
尯	尢 危
尰	尢 重
就	京 尤
尲	尢 兼
尳	尢 骨
尴	尢 监
尴	尢 监
尸	㇆ 一 丿
尹	彐 丿
尺	尸 乀
尻	尸 九
尼	尸 匕
尾	尸 毛
尿	尸 水
局	尸 ㇆ 口
屁	尸 比
屄	尸 穴
居	尸 古
届	尸 由
屇	尸 田
屈	尸 出
屋	尸 至
屌	尸 吊
尸	㇆ 一 丿
屎	尸 米
屏	尸 并
屐	尸 彳 支
屑	尸 肖
屒	尸 辰
屃	尸 贝
屔	丘 尼
展	尸 龷 
屖	尸 辛
屘	尾 子
屙	尸 阿
屚	尸 雨
屏	尸 并
屉	尸 世
屝	尸 非
屟	尸 枼
屠	尸 者
屡	尸 娄
屣	尸 徙
层	尸 云
履	尸 復
屧	尸 彳 枼
屦	尸 彳 娄
屪	尸 尞
属	尸 禹
屃	尸 贝
屮	凵 丨
屯	丿 凵 乚
屰	丷 一 屮
山	凵 丨
屳	入 山
屴	山 力
屵	山 厂
屸	山 工
屹	山 乞
屺	山 己
屻	山 刃
屼	山 兀
屽	山 干
屾	山 山
岄	山 月
岅	山 反
岆	山 夭
岇	山 卬
岈	山 牙
岉	山 勿
岊	巴 山
岋	山 及
岌	山 及
岍	山 开
岎	山 分
岏	山 元
岐	山 支
岑	山 今
岒	山 今
岓	山 斤
岔	分 山
岕	山 介
岙	夭 山
岜	山 巴
岝	山 乍
岞	山 乍
岟	山 央
岠	山 巨
冈	冂 乂
岢	山 可
岣	山 句
岤	山 穴
岥	山 皮
岦	山 立
岧	山 召
岨	山 且
岩	山 石
岪	山 弗
岫	山 由
岬	山 甲
岮	山 它
岯	山 丕
岰	山 幼
岱	代 山
岲	山 兄
岳	丘 山
岴	山 丘
岵	山 古
岶	山 白
岷	山 民
岸	山 厈
岹	山 召
岺	山 令
岻	山 氐
峀	山 田
峁	山 卯
峂	山 冬
峆	山 合
峇	山 合
峈	山 各
峉	山 各
峊	户 乛 一 山
峋	山 旬
峌	山 至
峍	山 聿
峎	山 艮
峏	山 而
峐	山 亥
峑	山 全
峒	山 同
峓	山 夷
峔	山 老
峕	山 亠 日
峖	山 安
峗	山 危
峘	山 亘
峙	山 寺
峚	山 圶
峛	山 列
峜	山 企
峝	山 同
峞	山 危
峟	山 有
峠	山 上 下
峢	山 列
峧	山 交
峨	山 我
峨	山 我
峪	山 谷
峫	山 邪
峬	山 甫
峭	山 肖
峮	山 君
峯	山 夆
峰	山 夆
峱	丑 山
峲	山 利
峳	山 攸
岘	山 见
峵	山 宏
岛	勹 丶 勹 山
峷	山 辛
峸	山 成
峹	余 山
峺	山 更
峻	山 夋
峼	山 告
峡	山 夹
峾	沂 山
峿	山 吾
崀	山 良
崁	山 坎
崅	山 角
崆	山 空
崇	山 宗
崈	宗 山
崉	山 沓
崌	山 居
崃	山 来
崎	山 奇
崏	山 昏
崐	山 昆
昆	日 比
崒	山 卒
崓	山 固
崔	山 隹
崕	山 厓
崖	山 厓
岗	山 冈
仑	人 匕
崚	山 夌
崛	山 屈
崜	山 垂
崝	山 青
崞	山 享
崟	山 金
崡	山 函
峥	山 争
崣	山 委
崤	山 肴
崥	山 卑
崦	山 奄
崧	山 松
崩	山 朋
崪	山 卒
崫	山 屈
岽	山 东
崮	山 固
崯	山 金
崲	山 皇
崳	山 俞
崴	山 威
崶	山 封
崷	山 酋
崹	山 帝
崺	山 施
崻	山 待
崼	山 是
崽	山 思
崾	山 要
崿	山 咢
嵀	山 柱
嵁	山 甚
嵂	山 律
嵃	山 彦
嵄	山 美
嵅	山 咸
嵆	禾 尤 山
嵇	禾 尤 山
嵈	山 爰
嵉	山 亭
嵊	山 乘
嵋	山 眉
嵌	山 甘 欠
嵍	敄 山
嵎	山 禺
嵏	山 凶 八 夂
岚	山 风
嵑	山 曷
嵒	品 山
嵓	山 品
嵔	山 畏
嵕	山 凶 八 夂
嵖	山 查
嵗	山 戊 一 小
嵛	山 俞
嵞	余 山 山
嵟	山 隹
嵠	山 奚
嵡	山 翁
嵢	山 倉
嵣	山 唐
嵤	火 火 冚
嵥	山 桀
嵧	山 留
嵩	山 高
嵫	山 兹
嵬	山 鬼
嵭	山 旁
嵮	山 真
嵯	山 差
嵰	山 兼
嵱	山 容
嵲	山 臬
嵳	山 差
嵴	山 脊
嵹	山 強
嵺	山 翏
嶀	山 雩
嵝	山 娄
嶂	山 章
崭	山 斩
嶅	敖 山
嶆	山 曹
岖	山 区
嶉	山 唯
嶊	山 推
嶍	山 習
嶎	山 尉
嶏	山 厂 配
嶐	山 隆
嶑	山 象
嶒	山 曾
嶓	山 番
嵚	山 钦
嶕	山 焦
嶖	山 翕
崂	山 劳
嶙	山 粦
嶚	山 尞
嶛	山 尞
嶜	山 朁
嶝	山 登
嶞	隋 山
嶟	山 尊
峤	山 乔
嶡	山 厥
峣	山 尧
嶣	崔 火
嶥	山 厥
嶦	山 詹
峄	山 又 二 丨
峃	小 冖 山
嶭	山 户 乛 一 辛
崄	山 佥
嶯	山 戢
嶰	山 解
嶱	山 葛
隽	隹 乃
嶳	山 豕 土 土
嶵	山 罪
嶷	山 疑
嵘	山 荣
岭	山 令
嶻	山 截
屿	山 与
岳	丘 山
巀	山 雀 戈
巂	山 隹 冏
巈	山 鞠
巉	山 毚
岿	山 归
岩	山 石
巍	山 魏
巎	山 夒
巏	山 雚
巐	山 高 昇
峦	亦 山
巓	山 顚
巅	山 顛 巔
巙	山 夔
川	丿 丨 丨
州	川 丶 丶 丶
巟	亡 川
巠	一 巛 工
巡	辶 巛
巢	巛 果
巢	巛 果
巤	巛 囗 乂 𠄌 丶 丶 𠄌 丶 丶 乀
工	一 丨 一
左	一 丿 工
巧	工 万
巨	匸 ㇆ 一
巫	工 人 人
差	羊 丿 工
巯	圣 巟
己	㇆ 一 乚
已	㇆ 一 乚
巳	㇆ 一 乚
巴	巳 丶
巵	厂 一 巴
巶	召 巳
巷	共 己
巹	丞 己
巺	巳 巳 一 八
卷	𠔉 㔾
巽	己 己 共
巾	冂 丨
巿	一 巾
帀	一 巾 巿
市	亠 巾
布	一 丿 巾
帄	巾 丁
帆	巾 凡
帇	彐 巾
帉	巾 分
帊	巾 巴
帋	氏 巾
希	乂 一 丿 巾
帍	户 巾
帎	巾 冘
帑	奴 巾
帒	代 巾
帓	巾 末
帔	巾 皮
帕	巾 白
帖	巾 占
帗	巾 犮
帘	奴 巾
帙	巾 失
帚	彐 冖 巾
帛	白 巾
帝	亠 丷 冖 巾
帞	巾 百
帟	亦 巾
帠	臼 巾
帢	巾 合
帣	𠔉 巾
帤	如 巾
帅	丨 丿 巾
帨	巾 兑
帩	巾 肖
帪	巾 辰
师	丨 丿 帀
帬	尹 吊
席	广 廿 巾
帯	丗 冖 巾
帡	巾 并
帐	巾 长
帵	巾 宛
带	卅 冖 巾
帷	巾 隹
常	尚 巾
帹	巾 妾
帺	巾 其
帽	巾 冒
帾	巾 者
帿	巾 侯
帧	巾 贞
帏	巾 韦
幄	巾 屋
幅	巾 畐
幆	巾 曷
帮	邦 巾
幈	巾 屏
幋	般 巾
幌	巾 晃
幍	巾 舀
幎	巾 冥
幏	巾 家
幐	月 丷 夫 巾
幑	彳 山 帀 攵
幒	巾 悤
幔	巾 曼
幕	莫 巾
幖	巾 票
帼	巾 国
帻	巾 责
幙	巾 莫
幚	邦 巾
幛	巾 章
幜	巾 景
幞	巾 菐
帜	巾 只
幡	巾 番
幢	巾 童
币	一 巾
幦	辟 巾
幧	巾 喿
幨	巾 詹
幪	巾 蒙
帮	邦 巾
帱	巾 寿
幭	巾 蔑
幮	巾 廚
干	二 丨
平	干 丷
年	丿 一 二 丶 丨
幵	千 干
幸	土 羊
干	一 十
幻	幺 ㇆
幼	幺 力
幽	山 幺 幺
几	丿 一 乚
庀	匕
厅	厂 丁
庂	广 人
广	丶 一 丿
庅	广 么
庇	广 比
庈	广 今
庉	广 屯
床	广 木
庋	广 支
庌	广 牙
庍	广 斤
庎	广 介
序	广 予
底	广 氐
庖	广 包
店	广 占
庘	广 甲
庚	广 肀 人
庛	广 此
府	广 付
庝	广 冬
庠	广 羊
庡	广 衣
庢	广 至
庣	广 兆
庤	广 寺
庥	广 休
度	广 廿 又
座	广 坐
庨	广 孝
庩	广 余
庪	广 技
库	广 车
庬	广 尨
庭	广 廷
庮	广 酉
庯	广 甫
庰	广 并
庱	广 夌
庳	广 卑
庴	广 昔
庵	广 奄
庶	广 廿 灬
康	广 隶
庸	广 聿 冂 二
庹	广 廿 尺
庺	广 枀
庻	广 廿 人 人
庽	广 禺
庾	广 臾
庿	广 苗
廀	广 叜
厕	厂 则
厢	厂 相 廂
废	广 发
厩	厂 既
廅	广 盍
廆	广 鬼
廇	广 留
厦	厂 夏
廉	广 兼
廊	广 郎
廋	广 叟
廌	广 乛 一 丨 丨 ㇉ 灬
廍	广 部
庼	广 顷
廏	广 白 匕 殳
廐	广 白 匕 旡
廑	广 堇
廒	广 敖
廓	广 郭
廖	广 翏
廘	广 鹿
厨	厂 豆 寸
廛	广 里 儿 土
廜	广 屠
厮	厂 斯 廝
庙	广 由 廟
厂	一 丿
庑	广 无
废	广 发
广	丶 一 丿
廦	广 辟
廨	广 解
廪	广 禀
庐	广 户
厅	厂 丁
廱	广 雝
厅	厂 丁
廵	廴 巛
延	廴 丿 止
廷	廴 壬
廸	廴 由
廹	廴 白
建	廴 聿
廻	廴 回
乃	丿 ㇆ ㇆
廻	廴 回
廾	一 丿 丨
廿	一 凵
弁	厶 廾
弄	王 廾
弅	分 廾
弆	去 廾
弇	合 廾
弈	亦 廾
弊	敝 廾
弋	一 乁 丶
弌	弋 一
弍	弋 二
弎	弋 三
式	弋 工
弐	一 弋 二
弑	杀 式 弒
弓	㇆ 一 ㇉
吊	口 巾
引	弓 丨
弖	弓 一
弗	弓 丿 丨
弘	弓 厶
弙	弓 于
弚	八 弔
弛	弓 也
弜	弓 弓
弝	弓 巴
弞	弓 欠
弟	丷 弓 丨 丿
弡	弓 巨
弢	弓 屮 又
弣	弓 付
弤	弓 氐
弦	弓 玄
弧	弓 瓜
弨	弓 召
弩	奴 弓
弫	弓 臣
弭	弓 耳
弮	𠔉 弓
弰	弓 肖
弱	弓 冫 弓 冫
弲	弓 肙
弪	弓 圣
弴	弓 享
张	弓 长
弶	弓 京
强	弓 虽
弸	弓 朋
弻	弓 丙 一 弓
弼	弓 百 弓
弽	弓 枼
弹	弓 单
弿	宀 井 大 弓
彀	士 冖 一 弓 殳
彂	业 矤
别	另 刂
弹	弓 单
彉	弓 黃
彊	弓 畺
彋	弓 睘
弥	弓 尔
弯	亦 弓
彏	弓 矍
录	彐 水
彖	彑 豕
彗	丰 丰 彐
彘	彑 匕 矢 匕
汇	氵 匚
彚	彐 冖 果
彛	彐 米 分 廾
彝	彑 米 糸 廾
彟	寻 蒦
彡	丿 丿 丿
形	开 彡
彣	丶 又 彡
彤	丹 彡
彦	亠 丷 厂 彡
彧	或 丿 丿
彩	采 彡
彪	虎 彡
雕	周 隹
彬	林 彡
彭	壴 彡
彮	容 彡
彯	票 彡
彰	章 彡
影	景 彡
彨	丽 彡
彳	丿 亻
彴	彳 勺
彵	彳 也
彶	彳 及
仿	亻 方
彸	彳 公
役	彳 殳
彺	彳 王
彼	彳 皮
彽	彳 氐
彾	彳 令
彿	彳 弗
往	彳 主
征	彳 正
徂	彳 且
徃	彳 生
待	彳 寺
徆	彳 西
徇	彳 旬
很	彳 艮
徉	彳 羊
徊	彳 回
律	彳 聿
后	厂 一 口
徍	彳 圭
徎	彳 呈
徏	彳 步
徐	彳 余
径	彳 圣
徒	彳 走
从	人 人
徖	彳 宗
得	彳 日 一 寸
徘	彳 非
徙	彳 止 疋
徛	彳 奇
徜	彳 尚
徝	彳 直
从	人 人
徟	彳 周
徕	彳 来
御	彳 卸
徢	彳 疌
徣	彳 昔
徤	彳 建
徥	彳 是
徦	彳 叚
徧	彳 扁
徨	彳 皇
复	丿 一 日 夂
循	彳 盾
徬	彳 旁
微	彳 山 兀 攵
徯	彳 奚
徰	彳 正 正
徱	彳 票
徲	彳 犀
德	彳 十 罒 一 心
徴	彳 山 王 攵
征	彳 正
徶	彳 敝
德	彳 十 罒 一 心
徸	彳 童
彻	彳 切
徼	彳 敫
徽	彳 山 糸 攵
徾	彳 山 一 言 攵
忀	彳 襄
忁	彳 日 出 大 水
忂	彳 瞿
心	丿 乚 丶 丶
必	心 丿
忇	忄 力
忈	二 心
忉	忄 刀
忊	忄 丁
忋	忄 己
忌	己 心
忍	刃 心
忎	千 心
忐	上 心
忑	下 心
忒	弋 心
忓	忄 干
忔	忄 乞
忕	忄 大
忖	忄 寸
志	士 心
忘	亡 心
忙	忄 亡
忚	忄 也
忛	忄 凡
应	广 小 一
忝	天 心
忞	文 心
忟	忄 文
忠	中 心
忡	忄 中
忢	五 心
忣	忄 及
忤	忄 午
忥	气 心
忦	忄 介
忨	忄 元
忩	公 心
忪	忄 公
快	忄 夬
忬	忄 予
忭	忄 卞
忮	忄 支
忯	忄 氐
忰	忄 卆
忱	忄 冘
忲	忄 太
忳	忄 屯
忴	忄 今
念	今 心
忶	忄 云
忷	忄 凶
忸	忄 丑
忹	忄 王
忺	忄 欠
忻	忄 斤
忼	忄 亢
忽	勿 心
忿	分 心
怇	忄 巨
怈	忄 世
怉	忄 包
怊	忄 召
怋	忄 民
怌	忄 丕
怍	忄 乍
怎	乍 心
怏	忄 央
怐	忄 句
怑	忄 半
怒	奴 心
怓	忄 奴
怔	忄 正
怕	忄 白
怖	忄 布
怗	忄 占
怘	古 心
怙	忄 古
怚	忄 且
怛	忄 旦
思	田 心
怞	忄 由
怟	忄 氐
怠	台 心
怡	忄 台
怢	忄 失
怣	失 心
怤	付 心
急	刍 心
怦	忄 平
性	忄 生
怨	夕 卩 心
怩	忄 尼
怪	忄 圣
怫	忄 弗
怬	忄 四
怭	忄 必
怮	忄 幼
怯	忄 去
怰	忄 玄
怱	匆 心
怲	忄 丙
怳	忄 兄
怴	忄 戉
怵	忄 术
怶	忄 皮
怷	朮 心
怸	术 心
怹	他 心
恀	忄 多
恁	任 心
恂	忄 旬
恃	忄 寺
恄	忄 吉
恅	忄 老
恒	忄 亘
恇	忄 匡
恈	忄 牟
恉	忄 旨
恊	忄 劦
恌	忄 兆
恍	忄 光
恎	忄 至
恏	好 心
恐	工 凡 心
恑	忄 危
恓	忄 西
恔	忄 交
恕	女 口 心
恗	忄 夸
恘	忄 休
恙	羊 心
恚	圭 心
恛	忄 回
恜	忄 式
恝	丰 刀 心
恞	忄 夷
恟	忄 匈
恠	忄 在
恡	忄 乂 厷
恢	忄 灰
恣	次 心
恤	忄 血
耻	耳 止
恦	忄 向
恧	而 心
恨	忄 艮
恩	因 心
恪	忄 各
恫	忄 同
恬	忄 舌
恭	共 小 丶
恮	忄 全
息	自 心
恰	忄 合
恱	忄 兊
恲	忄 并
恴	亠 日 心
惠	叀 心
恾	忄 芒
悀	忄 甬
悁	忄 肙
悂	忄 坒
悃	忄 困
悄	忄 肖
悦	忄 兑
悆	余 心
悇	忄 余
悈	忄 戒
悉	釆 心
悊	折 心
悋	忄 吝
悌	忄 弟
悍	忄 旱
悎	忄 告
悐	狄 心
悑	忄 甫
悒	忄 邑
悔	忄 每
悕	忄 希
悖	忄 孛
悗	忄 免
悘	医 心
悙	忄 亨
悚	忄 束
悛	忄 夋
悜	忄 呈
悝	忄 里
悮	忄 吴
悟	忄 吾
悠	攸 心
悡	利 心
悢	忄 良
患	串 心
悤	囱 心
悥	言 心
悧	忄 利
您	你 心
恼	忄 亠 乂 凵
恶	亚 心
悰	忄 宗
悱	忄 非
悲	非 心
悳	直 心
悴	忄 卒
怅	忄 长
闷	门 心
悷	忄 戾
悸	忄 季
悹	官 心
悺	忄 官
悻	忄 幸
悼	忄 卓
悽	忄 妻
悾	忄 空
悿	忄 忝
惁	析 心
惂	忄 臽
惃	忄 昆
惄	叔 心
情	忄 青
惆	忄 周
惇	忄 享
惈	忄 果
惉	沾 心
惋	忄 宛
惌	宀 怨
惍	忄 金
惎	其 心
惏	忄 林
惐	忄 或
惑	或 心
惒	和 心
惓	忄 卷
惔	忄 炎
惕	忄 易
惖	易 心
惗	忄 念
惘	忄 罔
惙	忄 叕
惚	忄 忽
惛	忄 昏
惜	忄 昔
惝	忄 尚
惞	忄 欣
惟	忄 隹
惠	一 由 厶 心
恶	亚 心
惢	心 心 心
惣	物 心
惤	忄 弦
惥	臾 心
惦	忄 店
惪	直 心
惰	忄 左 月
恼	忄 亠 乂 凵
恽	忄 军
想	相 心
惴	忄 耑
惵	忄 枼
惶	忄 皇
惷	春 心
惸	忄 旬 子
惹	若 心
惺	忄 星
恻	忄 则
惼	忄 扁
惽	忄 昬
惾	忄 凶 八 夂
惿	忄 是
愀	忄 秋
愁	秋 心
愂	勃 心
愃	忄 宣
愄	忄 畏
愅	忄 革
愆	衍 心
愈	俞 心
愉	忄 俞
愊	忄 畐
愋	忄 爰
愍	敃 心
愎	忄 复
意	音 心
愐	忄 面
愑	忄 勇
愒	忄 曷
愔	忄 音
愕	忄 咢
愖	忄 甚
愗	敄 心
愘	忄 客
愙	客 心
愚	禺 心
爱	爫 冖 友
惬	忄 匧
愝	忄 匽
愞	忄 耎
感	咸 心
愡	忄 怱
愢	忄 思
愣	忄 罒 方
愧	忄 鬼
愨	士 冖 一 殳 心
愫	忄 素
愬	朔 心
愭	忄 耆
愯	忄 隻
愰	忄 晃
愱	忄 疾
愲	忄 骨
愳	目 目 心
怆	忄 仓
愵	忄 弱
愶	忄 脅
恺	忄 岂
愹	忄 容
愺	忄 草
慎	忄 真
愽	忄 尃
忾	忄 气
慀	忄 奚
慁	圂 心
恿	甬 心
慃	忄 翁
栗	西 木
慅	忄 蚤
慆	忄 舀
慇	殷 心
慈	茲 心
慉	忄 畜
慊	忄 丶 丶 兼
态	太 心
慌	忄 荒
愠	忄 昷
慎	忄 真
慏	忄 冥
慒	忄 曹
慓	忄 票
慔	忄 莫
慕	莫 小 丶
慗	敕 心
惨	忄 参
惭	忄 斩
慛	忄 崔
慜	敏 心
慝	匿 心
慞	忄 章
恸	忄 动
慠	忄 敖
慡	忄 爽
慢	忄 曼
惯	忄 贯
悫	壳 心
慥	忄 造
慦	救 心
慧	彗 心
慨	忄 既
怄	忄 区
怂	从 心
慬	忄 堇
虑	虍 心
慰	尉 心
悭	忄 坚
慴	忄 習
慵	忄 庸
庆	广 大
慷	忄 康
㥪	忄 娄
慻	忄 丷 夫 目
慼	戚 心
慽	忄 戚
欲	谷 欠
憀	忄 翏
憁	忄 悤
忧	忄 尤
憃	舂 心
憄	徝 心
憅	動 心
憆	忄 堂
憇	甜 心
憉	忄 彭
惫	备 心
憋	敝 心
憎	忄 曽
憏	忄 祭
怜	忄 令
凭	任 几
愦	忄 贵
憓	忄 惠
憔	忄 焦
憕	忄 登
慭	来 犬 心
憘	忄 喜
憙	喜 心
惮	忄 单
憛	忄 覃
憜	忄 隋
憝	敦 心
憞	忄 敦
憟	忄 粟
憠	厥 心
憡	忄 策
憣	忄 番
愤	忄 贲
憧	忄 童
憨	敢 心
憩	舌 自 心
悯	忄 闵
憬	忄 景
憭	忄 尞
怃	忄 无
憯	忄 朁
憰	忄 矞
憱	忄 就
宪	宀 先
憵	辟 心
忆	忄 乙
憷	忄 楚
憺	忄 詹
憻	忄 亶
憼	敬 心
憽	忄 葱
憾	忄 感
憿	忄 敫
懀	忄 會
懁	忄 睘
懂	忄 董
懃	勤 心
懄	忄 勤
懅	忄 豦
懆	忄 喿
恳	艮 心
懈	忄 解
应	广 小 一
懊	心 奥
懋	楙 心
怿	忄 又 二 丨
懔	忄 禀
懏	忄 雋
怀	忄 不
懗	忄 赫
懝	忄 疑
懞	忄 蒙
怼	对 心
懑	满 心
懤	忄 壽
懥	忄 疐
懦	忄 需
恹	忄 厌
懩	忄 養
懪	忄 暴
懮	忄 憂
懯	敷 心
懱	忄 蔑
惩	征 心
懴	
懵	忄 瞢
懒	忄 赖
怀	忄 不
悬	县 心
懹	忄 襄
忏	忄 千
懻	忄 冀
惧	忄 具
懽	忄 雚
慑	忄 聂
懿	壹 恣
恋	亦 心
戂	忄 靡
戄	忄 矍
戆	立 早 攵 页 心
戈	一 乁 丿 丶
戊	丿 戈
戌	戊 一
戍	戊 丶
戎	一 十 戈
成	戊 ㇆
我	扌 戈
戒	廾 戈
戓	戈 口
戋	戈 一
戕	爿 戈
或	口 一 戈
戙	同 戈
戚	丿 上 小 戈
戛	一 自 戈
戜	戈 呈
戞	百 冖 戈
戟	十 早 戈
戠	音 戈
戡	甚 戈
戢	口 耳 戈
戣	癸 戈
戤	盈 戈
戥	星 戈
战	占 戈
戗	仓 戈
戨	哥 戈
戬	晋 戈
截	土 戈 隹
戫	有 或
戭	寅 戈
戮	翏 戈
战	占 戈
戯	虚 戈
戏	又 戈
戳	羽 隹 戈
戴	土 戈 異
戵	瞿 戈
户	丶 尸
戸	一 尸
戹	户 乙
戺	户 巳
戻	户 大
戼	㇆ 匸 戶
戽	户 斗
戾	户 大
房	户 方
所	户 斤
扁	户 冊
扂	户 占
扃	户 冋
扄	户 向
扅	户 多
扆	户 衣
扇	户 羽
扈	户 邑
扉	户 非
扊	户 炎
手	丿 二 亅
扌	一 亅 丿
才	一 亅 丿
扎	扌 乚
扏	扌 九
扐	扌 力
扒	扌 八
打	扌 丁
扔	扌 乃
拂	扌 弗
扗	扌 土
托	扌 乇
扙	扌 丈
扚	扌 勺
扛	扌 工
扜	扌 于
扝	扌 亏
扞	扌 干
扟	扌 卂
扠	扌 叉
扡	扌 也
扢	扌 乞
扣	扌 口
扤	扌 兀
扥	扌 丿 一 乚
扦	扌 千
扨	扌 刄
扭	扌 丑
扮	扌 分
扯	扌 止
扱	扌 及
扲	扌 今
扳	扌 反
扴	扌 介
扵	扌 仒
扶	扌 夫
扸	扌 片
批	扌 比
扺	扌 氏
扻	扌 欠
扼	扌 厄
扽	扌 屯
找	扌 戈
承	氶 三
技	扌 支
抁	扌 允
抂	扌 王
抃	扌 卞
抄	扌 少
抅	扌 勾
抆	扌 文
抇	扌 日
抈	扌 月
抉	扌 夬
把	扌 巴
抋	扌 心
抌	扌 冘
抍	扌 升
抎	扌 云
抏	扌 元
抐	
抑	扌 卬
抒	扌 予
抓	扌 爪
抔	扌 不
投	扌 殳
抖	扌 斗
抗	扌 亢
折	扌 斤
抙	扌 手
抜	扌 友
抝	扌 幻
择	扌 又 二 丨
抦	扌 丙
抧	扌 只
抨	扌 平
抩	扌 冉
抪	扌 布
披	扌 皮
抬	扌 台
抭	扌 宀 儿
抮	扌 人 彡
抯	扌 且
抰	扌 央
抱	扌 包
抲	扌 可
抳	扌 尼
抴	扌 世
抵	扌 氐
抶	扌 失
抷	扌 丕
抸	扌 乏
抹	扌 末
抺	扌 未
抻	扌 申
押	扌 甲
抽	扌 由
抾	扌 去
抿	扌 民
拀	扌 兄
拁	扌 加
拂	扌 弗
拃	扌 乍
拄	扌 主
拆	扌 斥
拇	扌 母
拈	扌 占
拉	扌 立
拊	扌 付
抛	扌 尢 力 拋
拌	扌 半
拍	扌 白
拎	扌 令
拏	奴 手
拐	扌 口 刀
拑	扌 甘
拒	扌 巨
拓	扌 石
拔	扌 犮
拕	扌 它
拖	扌 丿 一 也
拗	扌 幼
拘	扌 句
拙	扌 出
拚	扌 厶 廾
招	扌 召
拜	手 手
拜	手 手
拞	扌 丘
拠	扌 処
扩	扌 广
拪	扌 西
拫	扌 艮
括	扌 舌
拭	扌 式
拮	扌 吉
拯	扌 丞
拰	扌 任
拱	扌 共
拲	共 手
拳	𠔉 手
拴	扌 全
拵	扌 存
拶	扌 巛 夕
拷	扌 考
拸	扌 多
拹	扌 劦
拺	扌 朿
拻	扌 灰
拼	扌 并
拽	扌 曳
拾	扌 合
拿	合 手
挀	扌 厂 氏
持	扌 寺
挃	扌 至
挄	扌 光
挆	扌 朵
挆	扌 朵
指	扌 旨
挈	丰 刀 手
按	扌 安
挊	扌 上 下
挋	扌 臣
挌	扌 各
挍	扌 交
挎	扌 夸
挏	扌 同
挐	如 手
挑	扌 兆
挒	扌 列
挓	扌 宅
挔	扌 衣
挕	扌 耳
挖	扌 穵
挗	扌 夷
挨	扌 矣
捝	扌 兑
挪	扌 那
挫	扌 坐
挬	扌 孛
挭	扌 更
挮	扌 弟
振	扌 辰
挰	扌 呈
挱	扌 沙
挲	沙 手
挴	扌 每
挵	扌 弄
挶	扌 局
挷	扌 邦
挹	扌 邑
挺	扌 廷
挻	扌 延
挼	扌 妥
挽	扌 免
挟	扌 夹
捀	扌 夆
捁	扌 告
捃	扌 君
捄	扌 求
捅	扌 甬
捆	扌 困
捇	扌 赤
捈	扌 余
捉	扌 足
捊	扌 孚
捋	扌 寽
捌	扌 別
捍	扌 旱
捎	扌 肖
捏	扌 圼
捐	扌 肙
捑	扌 日 夨
捒	扌 束
捓	扌 邪
捔	扌 角
捕	扌 甫
捖	扌 完
捗	扌 步
捘	扌 夋
捚	扌 里
捛	
捜	扌 叟
捠	扌 兵
捥	扌 宛
捦	扌 金
捧	扌 奉
舍	人 舌
捩	扌 戾
捪	扌 昏
扪	扌 门
捬	扌 府
捭	扌 卑
据	扌 居
捯	扌 到
捰	扌 果
挨	扌 矣
捲	扌 卷
捳	扌 岳
搃	扌 总
捵	扌 典
捶	扌 垂
捷	扌 疌
捸	扌 隶
捹	扌 奔
捺	扌 奈
捻	扌 念
捼	扌 委
捽	扌 卒
捾	扌 官
捿	扌 妻
掀	扌 欣
掂	扌 店
扫	扌 彐
抡	扌 仑
掅	扌 青
掇	扌 叕
授	扌 受
掉	扌 卓
掊	扌 咅
掋	扌 底
掌	尚 口 手
掍	扌 昆
掎	扌 奇
掏	扌 匋
掐	扌 臽
掑	扌 其
排	扌 非
掓	扌 叔
掕	扌 夌
掖	扌 夜
挜	扌 亚
掘	扌 屈
挣	扌 争
挂	扌 圭
掜	扌 兒
掝	扌 或
掞	扌 炎
掟	扌 定
掠	扌 京
采	爫 木
探	扌 罙
掣	制 手
掤	扌 朋
接	扌 妾
掦	扌 易
控	扌 空
推	扌 隹
掩	扌 奄
措	扌 昔
掫	扌 取
掬	扌 匊
掭	扌 忝
掮	扌 肩
掯	扌 肯
掰	手 分 手
掱	手 手 手
掲	扌 日 勹 匕
掹	扌 孟
掻	
掽	扌 並
掾	扌 彖
掿	扌 若
拣	扌 东 一
揂	扌 酋
揃	扌 前
揄	扌 俞
揅	研 手
揆	扌 癸
揇	扌 南
揈	扌 訇
揉	扌 柔
揊	扌 畐
揋	扌 畏
揌	扌 思
揍	扌 奏
揎	扌 宣
描	扌 苗
提	扌 是
揑	扌 臼 工
插	扌 臿
揓	扌 施
搃	扌 总
揕	扌 甚
揖	扌 咠
揗	扌 盾
揘	扌 皇
揙	扌 扁
扬	扌 弓 丿 丿
换	扌 奂
揜	扌 弇
揝	扌 昝
揞	扌 音
揟	扌 胥
揠	扌 匽
握	扌 屋
揢	扌 客
揣	扌 耑
揤	扌 即
揥	扌 帝
揦	扌 剌
揧	剌 手
揨	扌 亭
揩	扌 皆
揪	扌 秋
揫	秋 手
揬	扌 突
揭	扌 曷
挥	扌 军
搄	扌 恒
揰	扌 重
揱	削 手
揲	扌 枼
揳	扌 契
援	扌 爰
揵	扌 建
揶	扌 耶
揷	扌 千 臼
揸	扌 查
背	北 月
揺	扌 爫 击
揼	扌 泵
搆	扌 冓
搇	扌 衾
搈	扌 容
搉	扌 隺
搊	扌 芻
搋	扌 虒
搌	扌 展
损	扌 员
搏	扌 尃
搐	扌 畜
搑	扌 茸
搒	扌 旁
搓	扌 差
搔	扌 蚤
搕	扌 盍
摇	扌 爫 缶
捣	扌 岛
搘	扌 耆
搙	扌 辱
搚	扌 脅
搛	扌 兼
搜	扌 叟
搝	扌 臭
搞	扌 高
搠	扌 朔
搡	扌 桑
搣	扌 烕
搤	扌 益
捶	扌 垂
搦	扌 弱
搧	扌 扇
搨	扌 日 羽
搪	扌 唐
搫	般 手
搬	扌 般
搭	扌 荅
搮	扌 栗
搯	扌 舀
搰	扌 骨
搱	扌 屖
搲	扌 窊
搳	扌 害
搴	宀 井 大 手
揾	扌 昷 搵
抢	扌 仓
搷	扌 真
搸	扌 秦
搹	扌 鬲
搻	合 手 手
搼	扌 拳
搽	扌 茶
搾	扌 窄
搿	手 合 手
捂	扌 吾
摁	扌 恩
摄	扌 聂
摉	扌 穴 人 夕
摍	扌 宿
摎	扌 翏
摏	扌 舂
摐	扌 從
掴	扌 国
摒	扌 屏
摓	扌 逢
摔	扌 率
摖	扌 祭
摘	扌 啇
摚	扌 堂
摛	扌 离
掼	扌 贯
摝	扌 鹿
摞	扌 累
搂	扌 娄
搃	扌 总
摡	扌 既
摢	扌 虖
摣	扌 虘
摤	扌 爽
摦	扌 瓠
摧	扌 崔
摨	扌 犀
摩	麻 手
摬	扌 竟
摭	扌 庶
摮	敖 手
挚	执 手
摱	扌 曼
抠	扌 区
摴	扌 雩
摵	扌 戚
抟	扌 专
摷	扌 巢
摸	扌 莫
摹	莫 手
折	扌 斤
掺	扌 参
摽	扌 票
摾	扌 强
摿	扌 人 音
撀	声 殳 手
撂	扌 畧
撅	扌 厥
撆	敝 手
撇	扌 敝
捞	扌 劳
撉	敦 手
撍	扌 旡 旡 日
撎	扌 壹
挦	扌 寻
撑	扌 掌
撒	扌 散
挠	扌 尧
撔	扌 景
撕	扌 斯
撖	扌 敢
撗	
撘	扌 答
撙	扌 尊
撚	扌 然
撛	扌 粦
撜	扌 登
撞	扌 童
挢	扌 乔
撠	扌 戟
撡	扌 叅
撢	扌 覃
掸	扌 单
撤	扌 育 攵
拨	扌 发
撦	扌 奢
撨	扌 焦
撩	扌 尞
抚	扌 无
撬	扌 毳
播	扌 番
撮	扌 最
撰	扌 巽
撱	扌 隋
扑	扌 卜
揿	扌 钦
撴	扌 敦
搅	扌 觉
挞	扌 达
撼	扌 感
撽	扌 敫
挝	扌 过
捡	扌 佥
擀	扌 幹
拥	扌 用
擂	扌 雷
掳	扌 虏
擅	扌 亶
撯	扌 着
择	扌 又 二 丨
擉	扌 蜀
击	二 山
挡	扌 当
操	扌 品 木
擎	敬 手
擏	扌 敬
擐	扌 睘
擑	扌 戢
擒	扌 禽
担	扌 旦
携	扌 隽
擖	扌 葛
擗	扌 辟
擘	辟 手
扷	扌 夭
据	扌 居
擛	扌 葉
擝	扌 盟
挤	扌 齐
抬	扌 台
擢	扌 翟
擤	扌 鼻
擦	扌 察
挙	兴 手
擨	扌 歋
擩	扌 需
拟	扌 以
擭	扌 蒦
擮	扌 截
摈	扌 宾
拧	扌 宁
搁	扌 阁
掷	扌 掷 郑
扩	扌 广
擵	扌 摩
擶	扌 箭
撷	扌 颉
擸	扌 巤
擹	扌 歎
摆	扌 罢
擞	扌 数
撸	扌 鲁
扰	扌 尤
攀	林 爻 大 手
攁	扌 養
攂	扌 畾
攃	扌 蔡
摅	扌 虑
撵	扌 辇
攈	扌 麇
攉	扌 霍
攌	扌 圜
攍	扌 嬴
拢	扌 龙
攐	扌 褰
攓	扌 蹇
拦	扌 兰
攕	扌 韱
撄	扌 婴
攗	扌 麋
攘	扌 襄
搀	扌 免 冫
撺	扌 窜
携	扌 隽
摄	扌 聂
攟	扌 麕
攠	扌 靡
攒	扌 赞
挛	亦 手
摊	扌 难
攥	扌 纂
攨	扌 穴 瓜 瓜 瓜
搅	扌 觉
攫	扌 瞿
揽	扌 览
攭	扌 蠡
攮	扌 囊
支	十 又
攰	支 力
攱	立 支
攲	奇 支
攴	卜 又
攵	丿 一 乂
收	丩 攵
攷	丂 攵
攸	亻 丨 攵
改	己 攵
攺	已 攵
攻	工 攵
攼	干 攵
攽	分 攵
放	方 攵
政	正 攵
敀	白 攵
敁	占 攴
敂	句 攵
敃	民 攵
敄	矛 攵
故	古 攵
敆	合 攴
敇	朿 攵
效	交 攵
敉	米 攵
敊	尗 攴
敋	各 攵
敍	余 攴
教	孝 攵
敏	每 攵
敐	辰 攵
救	求 攵
敒	伸 攵
敚	兑 攵
敔	吾 攵
敕	束 攵
敖	土 方 攵
败	贝 攵
叙	余 又
教	孝 攵
敜	念 攵
敝	丷 巾 八 攵
敞	尚 攵
敟	典 攵
敠	叕 攴
敡	易 攴
敢	丅 耳 攵
散	井 月 攵
敤	果 攴
敥	炎 攴
敦	享 攵
敧	奇 攴
敨	咅 攵
敪	叕 攵
敫	白 方 攵
敬	茍 攵
敭	易 攵
敮	臿 攴
敯	昬 攴
敱	豈 攴
敲	高 攵
整	束 攵 正
敌	舌 攵
敷	旉 攵
数	娄 攵
敹	卜 冖 一 米 攵
敻	刀 内 目 夂
敼	喜 攴
斀	蜀 攴
敛	佥 攵
毙	比 死
敩	学 攵
敩	学 攵
文	亠 乂
斈	文 子
齐	文 丿 丨
斊	文 耳
斌	文 武
斋	文 而
斐	非 文
斑	玉 文 王
斒	文 扁
斔	文 虫 臾
斓	文 阑
斖	文 臼 同 冖 且
斗	丶 丶 一 丨
斘	夕 斗
料	米 斗
斚	厶 厶 冖 斗
斛	角 斗
斜	余 斗
斝	口 口 冖 斗
斞	臾 斗
斟	甚 斗
斠	冓 斗
斡	十 日 十 人 斗
斢	黃 斗
斣	蜀 斗
斤	厂 丅
斥	斤 丶
斦	斤 斤
斧	父 斤
斨	爿 斤
斪	句 斤
斫	石 斤
斩	车 斤
斮	昔 斤
斯	其 斤
新	立 木 斤
斱	者 斤
斳	堇 斤
斴	粦 斤
斵	卯 亞 斤
斶	斤 蜀
断	丨 一 米 斤
方	亠 刀
斺	方 丿 一 介
斻	方 亢
于	二 亅
施	方 丿 一 也
斾	方 丿 一 巾
斿	方 丿 一 子
旁	亠 丷 冖 方
旂	方 丿 一 斤
旃	方 丿 一 円
旄	方 丿 一 毛
旅	方 丿 一 氏
旆	方 丿 一 巿
旇	方 丿 一 皮
旈	方 巟
旉	甫 方
旊	方 丿 一 瓦
旋	方 丿 一 疋
旌	方 丿 一 生
旍	方 丿 一 令
旎	方 丿 一 尼
族	方 丿 一 矢
旐	方 丿 一 兆
旑	方 奇
旒	方 丿 一 巟
旓	方 丿 一 肖
旔	方 建
旖	方 丿 一 奇
旗	方 丿 一 其
旙	方 番
旚	方 丿 一 票
旛	方 丿 一 番
旜	方 丿 一 亶
旝	方 丿 一 會
旞	方 丿 一 遂
旡	匸 丿 乚
既	艮 旡
旣	白 匕 旡
日	口 丶
旦	日 一
旨	匕 日
早	日 十
旪	日 十
旫	日 刀
旬	勹 日
旭	九 日
旮	九 日
旯	日 九
旰	日 干
旱	日 干
旲	日 大
旳	日 勺
旴	日 于
旵	日 山
旹	屮 一 日
旺	日 王
旻	日 文
旼	日 文
旽	日 屯
旾	屯 日
旿	日 午
昀	日 匀
昁	日 巿
昂	日 卬
昃	日 仄
昄	日 反
昅	日 及
昆	日 比
昇	日 升
昈	日 户
昉	日 方
昊	日 天
昋	夭 日
昌	日 日
昍	日 日
明	日 月
昏	氏 日
昐	日 分
昑	日 今
昒	日 勿
易	日 勿
昔	井 日
昕	日 斤
昖	日 公
昗	日 六
昘	日 方
昚	大 丷 日
昛	日 巨
昜	日 一 勿
昝	处 日
昞	日 丙
星	生 日
映	日 央
昡	日 玄
昢	日 出
昣	日 人 彡
昤	日 令
春	龹 日
昦	日 夰
昧	日 未
昨	日 乍
昩	日 末
昪	日 弁
昫	日 句
昬	民 日
昭	日 召
昮	日 功
是	曰 疋
昰	日 正
昱	日 立
昲	日 弗
昳	日 失
昴	日 卯
昶	永 日
昷	日 皿
昸	日 冬
昹	日 永
昺	日 丙
昻	日 卬
旷	日 广
晀	日 兆
晁	日 兆
时	日 寸
晃	日 光
晄	日 光
晅	日 亘
晆	日 圭
晇	日 夸
晈	日 交
晋	亚 日
晊	日 至
晌	日 向
晍	日 同
晎	日 共
晏	日 安
晐	日 亥
晑	日 向
晗	日 含
晘	日 旱
晙	日 夋
晚	日 免
晜	日 弟
昼	尺 旦
晞	日 希
晟	日 成
晠	日 成
晡	日 甫
晢	折 日
晣	日 折
晤	日 吾
晥	日 完
晦	日 每
晧	日 告
晨	日 辰
晩	日 免
晪	日 典
晫	日 卓
晬	日 卒
晭	日 周
普	丷 晋
景	日 京
晰	日 析
晱	日 炎
晲	日 兒
晳	析 日
晴	日 青
晵	户 攵
晶	日 日 日
晷	日 咎
晸	日 政
晹	日 易
智	知 日
晻	日 奄
晼	日 宛
晽	日 林
晾	日 京
晿	日 昌
暀	日 往
晓	日 尧
暄	日 宣
暅	日 恒
暆	日 施
暇	日 叚
晕	日 军
晖	日 军
暋	敃 日
暌	日 癸
暍	日 曷
暎	日 英
暏	日 者
暑	日 者
暒	日 星
暓	敄 日
暔	日 南
暕	日 柬
暖	日 爰
暗	日 音
旸	日 弓 丿 丿
暙	日 春
暚	日 爫 缶
暛	日 差
暜	立 立 日
暝	日 冥
暞	日 臬
暠	日 高
暡	日 翁
畅	申 弓 丿 丿
暤	日 皋
暥	日 妟
暦	厂 林 日
暨	既 旦
暩	日 祭
暂	斩 日
暭	日 皐
暮	莫 日
暯	日 莫
昵	日 尼
暲	日 章
暳	日 彗
暴	日 恭
暵	日 革 大
暶	日 旋
暸	日 尞
暹	日 進
暺	日 單
暻	日 景
暼	敝 日
暽	日 粦
暾	日 敦
暿	日 喜
曀	日 壹
曁	旣 旦
曂	日 黄
曃	日 逮
晔	日 华
历	厂 力
昙	日 云
曈	日 童
晓	日 尧
曋	日 覃
曌	明 空
曍	日 臯
曐	晶 生
曑	晶 人 彡
曒	日 敫
曓	日 出 大 本
曔	日 敬
曕	日 詹
暧	日 爱
曘	日 需
曙	日 署
曚	日 蒙
曛	日 熏
曜	日 翟
曝	日 暴
曟	晶 辰
旷	日 广
曡	晶 冝
曣	日 燕
曤	日 霍
曦	日 羲
曧	日 融
昽	日 龙
曩	日 囊
晒	日 西
曰	曰 一
曱	口 丅
曲	曰 丨 丨
曳	曰 乁 丿
更	一 曰 人
曵	日  乀 丿 丶
曶	勿 日
曷	日 勹 丨 一 人
书	㇆ ㇆ 丨 丶
曹	一 丨 丨 曰 日
曺	一 由 日
曼	曰 目 又
曽	丷 田 日
曾	八 口 丨 丷 曰
替	夫 夫 日
最	日 取
朁	兓 日
朂	日 耳 力
会	人 云
朅	去 曷
朆	曾 勿
月	冂 一 一
有	一 丿 月
朊	月 元
朋	月 月
朌	月 分
服	月 卩 又
朎	月 令
朏	月 出
朐	月 句
朒	月 肉
朓	月 兆
朔	屰 月
朕	月 关
朖	月 良
朗	良 月
朘	月 夋
朙	囧 月
朚	亡 明
望	亡 月 王
朜	月 享
朝	卓 月
朞	其 月
期	其 月
朠	月 英
朡	月 凶 八 夂
朣	月 童
朤	月 月 月 月
朦	月 蒙
胧	月 龙
木	十 八
朩	一 小
未	一 木
末	木 一
本	木 一
札	木 乚
朮	十 儿 丶
朱	丶 未
朲	木 人
朳	木 八
朴	木 卜
朵	几 木
朵	几 木
朷	木 刀
朸	木 力
朹	木 九
朻	木 丩
朼	木 匕
朽	木 丂
朾	木 丁
朿	木 冂
杄	木 千
杅	木 于
杆	木 干
杇	木 亏
杈	木 叉
杉	木 彡
杊	木 川
杋	木 凡
杌	木 兀
杍	木 子
李	木 子
杏	木 口
材	木 才
村	木 寸
杒	木 刃
杓	木 勺
杔	木 乇
杕	木 大
杖	木 丈
杗	木 亡
杘	尸 木 
杙	木 弋
杚	木 乞
杛	木 弓
杜	木 土
杝	木 也
杞	木 己
束	木 口
杠	木 工
杧	木 亡
杪	木 少
杫	木 止
杬	木 元
杭	木 亢
杮	木 巿
杯	木 不
杰	木 灬
东	一 𠃋 小
杲	日 木
杳	木 日
杴	木 欠
杵	木 午
杶	木 屯
杷	木 巴
杸	木 殳
杹	木 化
杺	木 心
杻	木 丑
杼	木 予
杽	木 手
松	木 公
板	木 反
枀	公 木 
枂	木 月
枃	木 匀
枅	木 开
枆	木 毛
枇	木 比
枈	比 木
枉	木 王
枊	木 卬
枋	木 方
枌	木 分
枍	木 兮
枎	木 夫
枏	木 冄
析	木 斤
枑	木 互
枒	木 牙
枓	木 斗
枔	木 今
枕	木 冘
枖	木 夭
林	木 木
枘	木 内
枙	木 厄
枚	木 攵
枛	木 爪
果	日 木
枝	木 支
枡	木 升
枬	木 丹
枮	木 占
枯	木 古
枰	木 平
台	厶 口
枲	台 木
枳	木 只
枵	木 号
架	加 木
枷	木 加
枸	木 句
枹	木 包
枺	木 末
枻	木 世
枼	世 木
枽	卋 木
枾	木 亠 十 丿 丨
枿	木 卉
柀	木 皮
柁	木 它
柂	木 丿 一 也
柃	木 令
柄	木 丙
柅	木 尼
柆	木 立
柇	木 禾
柈	木 半
柉	木 乏
柊	木 冬
柋	代 木
柌	木 司
柍	木 央
柎	木 付
柏	木 白
某	甘 木
柑	木 甘
柒	氵 七 木
染	氵 九 木
柔	矛 木
柕	木 矛
柖	木 召
柗	木 八 口
柘	木 石
柙	木 甲
柚	木 由
柛	木 申
柝	木 拆
柞	木 乍
柟	木 冉
柡	木 二 水
柢	木 氐
柣	木 失
柤	木 且
查	木 旦
柦	木 旦
柧	木 瓜
柩	木 久
柪	木 幼
柫	木 弗
柬	木 囗 丷
柭	木 犮
柮	木 出
柯	木 可
柰	木 示
柱	木 主
柲	木 必
柳	木 卯
柴	此 木
栅	木 册
柶	木 四
柷	木 兄
柸	木 丕
柹	木 丿 ㇉ 丨 丿
拐	扌 另
査	木 且
柼	木 穴
柾	木 正
柿	木 市
栀	木 卮
栁	木 夕 卩
栂	木 母
荣	艸 冖 木
栐	木 永
栒	木 旬
栓	木 全
栔	丰 刀 木 
栕	木 臣
栗	襾 木
栘	木 多
栙	木 夅
栚	木 关
栛	木 劦
栜	木 朿
栝	木 舌
栞	干 干 木
栟	木 并
栠	任 木
校	木 交
栢	木 百
栣	木 任
栤	木 冰
栥	次 木
栦	木 州
栧	木 曳
栨	木 次
栩	木 羽
株	木 朱
栫	木 存
栬	木 色
栭	木 而
栮	木 耳
栯	木 有
栰	木 伐
栱	木 共
栲	木 考
栳	木 老
栴	木 丿 一 円
栵	木 列
核	木 亥
根	木 艮
栺	木 旨
栻	木 式
格	木 各
栽	土 戈 木
栿	木 伏
桀	舛 木
桁	木 行
桂	木 圭
桃	木 兆
桄	木 光
桅	木 危
框	木 匡
桇	如 木
案	安 木
桉	木 安
桊	𠔉 木
桋	木 夷
桌	木 卜 日
桍	木 夸
桎	木 至
桏	木 邛
桐	木 同
桑	木 又 又 又
桒	卉 木
桓	木 亘
桔	木 吉
桕	木 臼
桖	木 血
桗	木 朶
桘	木 户 乛 一
桙	木 牟
桚	木 巛 夕
樱	木 婴
栈	木 戋
桫	木 沙
桬	沙 木
桭	木 辰
桮	木 否
桯	木 呈
桰	木 氏 口
桲	木 孛
桳	木 厶 大 十
桴	木 孚
桵	木 妥
桶	木 甬
桷	木 角
桸	木 希
桹	木 良
桺	木 丣
桻	木 夆
桼	木 水
桽	木 坐
桾	木 君
杆	木 干
梀	木 束
梁	氵 刅 木
梂	木 求
梃	木 廷
梄	木 酉
梅	木 每
梆	木 邦
梇	木 弄
梈	木 亨
梊	折 木
梋	木 肙
梌	木 余
梍	木 白 七
梎	木 皂
梏	木 牛 口
梐	木 比 土
梑	木 狄
梒	木 含
梓	木 辛
梔	木 巵
梕	木 忍
梗	木 更
枧	木 见
梙	木 串
梚	木 免
梛	木 那
条	夂 木
梞	木 忌
枭	鸟 木
梡	木 完
梢	木 肖
梣	木 岑
梤	木 山 分
梥	宀 枀
梧	木 吾
梨	利 木
梩	木 里
梪	木 豆
梫	木 彐 冖 又
梬	木 甹
梭	木 夋
梮	木 局
梯	木 弟
械	木 戒
梱	木 困
棁	木 兑
梳	木 巟
梴	木 延
梵	木 木 凡
梶	木 尾
梷	占 又 木
梸	木 利
梹	木 兵
梽	木 志
棃	禾 勹 丿 木
弃	亠 厶 廾
棅	木 秉
棇	木 公 心
棈	木 青
棉	木 帛
棊	其 木
棋	木 其
棌	木 采
棍	木 昆
棎	木 穼
棏	木 日 一 寸
棐	非 木
棑	木 非
棒	木 奉
棓	木 咅
棔	木 昏
棕	木 宗
枨	木 长
枣	朿 冫
棘	朿 朿
棙	木 戾
棚	木 朋
棛	木 育
棝	木 固
棞	木 囗 禾
栋	木 东
棠	尚 木
棢	木 罔
棣	木 隶
棤	木 昔
棥	林 爻
栈	木 戋
棨	户 攵
棪	木 炎
棫	木 或
棬	木 卷
棭	木 夜
森	木 林
棯	木 念
棰	木 垂
棱	木 夌
栖	木 西
棳	木 叕
棴	木 服
棵	木 果
梾	木 来
棷	木 取
棸	取 木
棹	木 卓
棺	木 官
棻	芬 木
棼	林 分
棽	林 今
棾	林 冗
棿	木 兒
椀	木 宛
椁	木 享
椂	木 录
椃	木 虎
椄	木 妾
椅	木 奇
椆	木 周
椇	木 具
椈	木 匊
椉	亠 舛 木
椊	木 卒
椋	木 京
椌	木 空
植	木 直
椎	木 隹
桠	木 亚
椐	木 居
椑	木 卑
椒	木 叔
椓	木 豖
椔	木 甾
椕	木 分 木
椖	木 房
椗	木 定
椘	林 之
检	木 佥
椞	析 木
椥	木 知
椪	木 並
椯	木 耑
椰	木 耶
椱	木 复
椳	木 畏
椴	木 段
椵	木 叚
椶	木 凶 八 夂
椷	木 咸
椸	木 施
椹	木 甚
椺	木 保
椻	木 匽
椼	木 衍
椽	木 彖
椾	木 前
椿	木 春
楀	木 禹
楁	木 客
楂	木 查
楃	木 屋
楄	木 扁
楅	木 畐
楆	木 要
楈	木 疋 月
楉	木 若
杨	木 弓 丿 丿
楋	木 剌
楌	木 彦
楍	木 口 口 口
楏	木 奎
楐	木 界
楑	木 癸
楒	木 思
枫	木 风
楔	木 契
楕	木 左 月
楖	木 即
楗	木 建
楘	敄 木
楙	木 矛 木
楚	林 疋
楛	木 苦
楜	木 胡
楝	木 柬
愣	忄 罒 方
楟	木 亭
楠	木 南
楡	木 俞
楢	木 酋
楣	木 眉
楤	木 怱
楥	木 爰
楦	木 宣
楧	木 英
桢	木 贞
楩	木 便
楪	木 枼
楫	木 口 耳
楬	木 曷
业	丨 丨 丷 一
楮	木 者
楯	木 盾
楰	木 臾
楱	木 奏
楲	木 威
楳	木 某
楴	木 帝
极	木 及
楶	次 呆
楷	木 皆
楸	木 秋
楹	木 盈
楺	木 柔
楻	木 皇
乐	丿 丨 朩
榀	木 品
概	木 既
榃	林 田
榆	木 俞
榊	木 神
榍	木 屑
榎	木 夏
榏	木 益
榐	木 展
榑	木 尃
榒	木 弱
榓	木 必 皿
榔	木 郎
榕	木 容
榖	士 冖 一 木 殳
榘	矩 木
榙	木 荅
榚	木 羔
榛	木 秦
榜	木 旁
榞	木 原
榟	木 宰
榠	木 冥
榡	木 素
榢	木 家
榤	木 桀
榥	木 晃
榦	十 日 十 人 木
榧	木 匪
榨	木 窄
榩	木 虔
杩	木 马
榫	木 隹 十
榬	木 袁
榭	木 射
荣	艸 冖 木
榰	木 耆
榱	木 衰
榅	木 昷
榳	木 庭
榴	木 留
榵	木 茸
榶	木 唐
榷	木 隺
榸	木 埋
榹	木 虒
榺	月 桊
榻	木 曰 羽
榼	木 盍
榽	木 奚
榾	木 骨
桤	木 岂
槀	高 木
槁	木 高
槃	般 木
槄	木 舀
槅	木 鬲
槆	木 荀
槇	木 真
槈	木 辱
槉	木 疾
槊	木 朔
构	木 勾
槌	木 追
枪	木 仓
槎	木 差
槏	木 兼
槐	木 鬼
槑	呆 呆
槒	木 畜
杠	木 工
槔	木 皋
槕	木 卓
槖	士 冖 石 木
样	木 羊
槙	木 真
槜	木 隽
槢	木 習
槣	木 寄
梿	木 连
槥	木 彗
槦	木 庸
椠	木 斩
槨	木 郭
槩	木 既
概	木 既
槬	木 瓠
槭	木 戚
椮	木 参
槯	木 崔
槰	木 逢
槱	木 酉 灬
槲	木 斛
桨	丬 夕 木
槴	木 扈
槵	木 患
槷	埶 木
槸	木 埶
槹	木 皐
槺	木 康
椝	木 规
槽	木 曹
槾	木 曼
槿	木 堇
樀	木 啇
桩	木 庄
乐	匚 小
樃	木 朗
枞	木 从
樆	木 离
樇	木 脩
樈	木 竟
樉	木 爽
樊	棥 大
樋	木 通
樎	木 宿
樏	木 累
樑	木 梁
樒	木 密
楼	木 娄
樔	木 巢
樕	木 欶
樖	合 柯
樗	木 雩
樘	木 堂
标	木 示
樚	木 鹿
樛	木 翏
樜	木 庶
樝	木 虘
枢	木 区
樟	木 章
模	木 莫
样	木 羊
樥	木 莑
樦	木 竹 主
榝	木 殺
樨	木 犀
权	木 又
樬	木 悤
桪	木 寻
枳	木 只
樵	木 焦
樶	木 最
樷	林 取
朴	木 卜
树	木 又 寸
桦	木 华
樼	木 孱
樽	木 尊
樾	木 越
椫	木 单
橀	木 巟 皿
橂	木 奠
橄	木 敢
橆	丿 一 卌 一 林
橇	木 毳
桡	木 尧
橉	木 粦
橊	木 畱
桥	木 乔
橎	木 番
橏	木 善
橐	一 中 冖 木 石
橑	木 尞
枟	木 云
橓	木 舜
橔	木 敦
橖	木 棠
橗	木 萌
橘	木 矞
橙	木 登
橛	木 厥
橜	厥 木
橝	木 覃
橞	木 惠
机	木 几
橠	木 袲
橡	木 象
椭	木 隋 橢
橣	木 甯
橤	惢 木
橦	木 童
橧	木 曾
橪	木 然
横	木 黄
橬	木 朁
橭	木 辜
橰	木 臯
橶	木 戟
橷	木 北 白 几
橾	木 喿
橿	木 畺
檀	木 亶
檩	木 禀
檄	木 敫
檅	木 歲
檆	木 煔
檇	木 雋
檈	木 睘
柽	木 圣
檊	木 幹
檌	木 罪
檍	木 意
檎	木 禽
檑	木 雷
檓	木 毀
档	木 当
檕	車 凵 殳 木
檖	木 遂
檗	辟 木
檘	木 辟
檙	木 鼎
檚	木 楚
桧	木 会
檝	木 戢
檞	木 解
槚	木 贾
檠	敬 木
检	木 佥
樯	木 啬
檤	木 道
檦	木 剽
檧	木 葱
檨	木 羨
檫	木 察
檬	木 蒙
梼	木 寿
台	厶 口
檱	木 箕
槟	木 宾
檴	木 蒦
檵	木 丨 一 幺 幺 一 幺 幺
柠	木 宁
檹	木 旖
檺	木 豪
槛	木 监
檽	木 需
檿	壓 木
櫀	木 綦
櫁	木 蜜
櫂	木 翟
柜	木 巨
櫄	木 熏
櫆	木 魁
櫈	木 凳
橱	木 厨
櫋	木 臱
櫏	木 遷
櫐	畾 木
櫑	木 畾
櫒	木 蔡
橹	木 鲁
櫗	木 蔑
櫘	木 慧
榈	木 门 吕
栉	木 节
櫜	一 中 冂 处 呆
椟	木 卖
橼	木 缘
栎	木 乐
櫡	木 箸
橱	木 厨
槠	木 诸
栌	木 卢
枥	木 历
橥	木 猪
榇	木 亲
櫭	木 暨
櫮	木 噩
櫰	木 褱
櫱	辥 木
櫲	木 豫
栊	木 龙
榉	木 举
櫺	木 霝
樱	木 婴
櫼	木 韱
櫾	木 爫 缶 系
欀	木 襄
欂	木 薄
欃	木 毚
栏	木 兰
欇	木 聶
欈	木 巂
权	木 又
欋	木 瞿
欎	棥 冖 艮 寸
椤	木 罗
栾	亦 木
欔	木 矍
榄	木 览
欙	木 纍
欚	木 蠡
欜	木 囊
欝	棥 罒 艮 寸
棂	木 灵
欠	刀 人
次	冰 欠
欣	斤 欠
欥	日 欠
欦	今 欠
欨	句 欠
欩	召 欠
欪	出 欠
欫	午 止 欠
欬	亥 欠
欭	因 欠
欮	屰 欠
欯	吉 欠
欰	血 欠
欱	合 欠
欲	谷 欠
欳	卜 冊 欠
欴	良 欠
欵	匕 矢 欠
欶	束 欠
欷	希 欠
欸	矣 欠
欹	奇 欠
欺	其 欠
欻	炎 欠
欼	叕 欠
钦	钅 欠
款	士 示 欠
欿	臽 欠
歀	柰 欠
歁	甚 欠
歂	耑 欠
歃	臿 欠
歅	垔 欠
歆	音 欠
歇	曷 欠
歈	俞 欠
歉	兼 欠
歊	高 欠
歋	虒 欠
歌	哥 欠
叹	口 又
歏	堇 欠
欧	区 欠
歑	虖 欠
歒	啇 欠
欢	又 欠
歔	虚 欠
歖	喜 欠
歘	焱 欠
歙	翕 欠
歜	蜀 欠
欤	与 欠
歠	叕 酉 欠
欢	又 欠
止	上 丨
正	一 止
此	止 匕
步	止 亅 丶 丿
武	一 弋 止
歧	止 支
歨	止 卜 人
歩	止 少
歪	不 正
歫	止 巨
歬	止 舟
歭	止 寺
歮	止 止 止
齿	止 人 凵
歰	刃 刃 止 止
歱	止 重
岁	山 夕
岁	山 夕
歴	厂 林 止
歶	此 禺
历	厂 力
归	丨 丿 彐
歹	一 夕
歺	卜 夕
死	一 夕 匕
歽	歹 斤
歾	歹 勿
殁	歹 殳
殀	歹 夭
殂	歹 且
殃	歹 央
殄	歹 人 彡
殅	歹 生
殆	歹 台
殈	歹 血
殉	歹 旬
殊	歹 朱
殍	歹 孚
殏	歹 求
殐	歹 束
殑	歹 克
殔	歹 隶
殕	歹 咅
殖	歹 直
殗	歹 奄
残	歹 戋
殙	歹 昏
殛	歹 亟
殜	歹 枼
殒	歹 员
殟	歹 昷
殠	歹 臭
殢	歹 帶
殣	歹 堇
殇	歹 丿 一 弓 丿 丿
殥	歹 寅
殧	歹 就
殩	歹 粲
殪	歹 壹
殚	歹 单
僵	亻 畺
殓	歹 佥
殡	歹 宾
歼	歹 千
殳	几 又
段	丿 丰 殳
殶	主 殳
殷	㐆 殳
殸	声 殳
殹	医 殳
杀	乂 木
壳	士 冗
壳	士 冗
殽	肴 殳
殾	者 殳
殿	尸 共 殳
毁	臼 工 殳
毃	高 殳
毅	立 豕 殳
殴	区 殳
毇	臼 米 殳
毈	卵 段
毉	殹 巫
母	丨 一 二 丶 丶 亅
每	丿 一 母
每	丿 一 母
毐	士 母
毑	母 也
毒	丰 母
毓	每 巟
比	匕 匕
毖	比 必
毗	田 比
毘	田 比
毚	刀 口 比 兔
毛	丿 一 匕
毞	比 毛
毠	加 毛
毢	毛 西
毣	羽 毛
毤	兊 毛
毥	毛 旬
毦	耳 毛
毧	毛 戎
毨	毛 先
毩	毛 米
毪	毛 牟
毫	亠 口 冂 毛
毬	毛 求
毭	豆 毛
毯	毛 炎
毰	毛 咅
毱	毛 匊
毲	叕 毛
毳	毛 毛 毛
毴	毛 非
毷	冒 毛
毸	毛 思
毹	俞 毛
毺	毛 俞
毻	左 月 毛
毼	曷 毛
毽	毛 建
毾	日 羽 毛
毵	参 毛
氁	毛 莫
牦	牜 毛
氃	童 毛
氄	矞 毛
氅	敞 毛
氆	毛 普
毡	毛 占
氉	喿 毛
毡	毛 占
氋	蒙 毛
氇	毛 鲁
氍	瞿 毛
氎	畾 宀 彑 毛
氐	氏 丶
氒	氏 十
氓	亡 民
氕	气 丿
氖	气 乃
气	丿 一 一 乙
氘	气 丿 丨
氙	气 山
氚	气 川
氛	气 分
氜	气 日
氝	气 內
氟	气 弗
氠	气 申
氡	气 冬
气	丿 一 一 乙
氤	气 因
氥	气 西
氦	气 亥
氧	气 羊
氨	气 安
氪	气 克
氢	气 圣
氩	气 亚
氮	气 炎
氯	气 录
氰	气 青
氲	气 昷
水	乛 亅 丶 乀
氵	丶 丶 丿
氶	了 ㇆ 丶 乀
氷	丶 水
永	丶 一 水
氹	乙 水
氻	氵 力
氼	水 人
氽	人 水
氾	氵 卩
氿	氵 九
汀	氵 丁
汁	氵 十
求	水 一 丶
汃	氵 八
汄	氵 人
汅	氵 丂
汆	入 水
汈	氵 刁
汊	氵 叉
汋	氵 勺
汌	氵 川
汍	氵 丸
汎	氵 凡
汏	氵 大
汐	氵 夕
汑	氵 乇
汒	氵 亡
汓	氵 子
汔	氵 乞
汕	氵 山
汖	山 水
汗	氵 干
汘	氵 千
污	氵 亏
污	氵 亏
汛	氵 卂
汜	氵 巳
汝	氵 女
汞	工 水
江	氵 工
池	氵 也
污	氵 亏
汥	氵 支
汦	氵 氏
汧	氵 开
汨	氵 日
汩	氵 日
汪	氵 王
汫	氵 井
汬	井 水
汭	
汮	氵 勻
汯	氵 厷
汰	氵 太
汱	氵 犬
汲	氵 及
汳	氵 反
汴	氵 卞
汵	氵 今
汶	氵 文
汷	氵 攵
汸	氵 方
决	冫 夬
汻	氵 午
汽	氵 气
汾	氵 分
汿	氵 予
沀	水 予
沁	氵 心
沂	氵 斤
沃	氵 夭
沅	氵 元
沆	氵 亢
沇	氵 允
沈	氵 冘
沊	冘 水
沌	氵 屯
沍	氵 互
沎	氵 化
沏	氵 切
沐	氵 木
沑	氵 丑
没	氵 殳
沓	氵 日
沔	氵 丏
沕	氵 勿
冲	冰 中
沗	天 水
沘	氵 比
沙	氵 少
沚	氵 止
沛	氵 巿
沜	氵 片
沝	水 水
沞	氵 帀
沠	氵 爪
泽	氵 又 二 丨
沣	氵 丰
沫	氵 末
沬	氵 未
沭	氵 朮
沮	氵 且
沯	水 石
沰	氵 石
沱	氵 它
沲	氵 丿 一 也
河	氵 可
沴	氵 人 彡
沶	氵 示
沷	氵 犮
沸	氵 弗
油	氵 由
沺	氵 田
治	氵 台
沼	氵 召
沽	氵 古
沾	氵 占
沿	氵 八 口
泀	氵 司
况	冫 兄
泂	氵 冋
泃	氵 句
泄	氵 世
泅	氵 囚
泆	氵 失
泇	氵 加
泈	氵 冬
泉	白 水
泊	氵 白
泋	氵 卉
泌	氵 必
泍	氵 本
泎	氵 乍
泏	氵 出
泐	氵 阞
泑	氵 幼
泒	氵 瓜
泓	氵 弘
泔	氵 甘
法	氵 去
泖	氵 卯
泗	氵 四
泘	氵 乎
泙	氵 平
泚	氵 此
泛	氵 乏
泜	氵 氐
泝	氵 斥
泟	氵 正
泠	氵 令
泡	氵 包
波	氵 皮
泣	氵 立
泤	氵 以
泥	氵 尼
泦	氵 尻
泧	氵 戉
注	氵 主
泩	氵 生
泫	氵 玄
泬	氵 穴
泭	氵 付
泮	氵 半
泯	氵 民
泰	龹 水
泱	氵 央
泲	氵 丿 ㇉ 丨 丿
泳	氵 永
泴	水 皿
泵	石 水
泿	氵 艮
洀	氵 舟
洂	氵 亦
洃	氵 灰
洄	氵 回
洅	氵 再
洆	氵 丞
洇	氵 因
洈	氵 危
洉	氵 后
洊	氵 存
洋	氵 羊
洌	氵 列
洎	氵 自
洏	氵 而
洐	氵 行
洑	氵 伏
洓	氵 朿
洔	氵 寺
洕	氵 水 八 肉
洖	氵 吳
洗	氵 先
洘	氵 考
洙	氵 朱
洚	氵 夅
洛	氵 各
洝	氵 安
洞	氵 同
洟	氵 夷
洠	氵 牟
洡	氵 耒
洢	氵 伊
洣	氵 米
洤	氵 全
津	氵 聿
洦	氵 百
洧	氵 有
洨	氵 交
洩	氵 曳
洪	氵 共
洫	氵 血
洬	氵 夙
洭	氵 匡
洮	氵 兆
洯	氵 丰 刀
洰	氵 巨
洱	氵 耳
洲	氵 州
洳	氵 如
洴	氵 并
洵	氵 旬
汹	氵 凶
洷	氵 至
洸	氵 光
洹	氵 亘
洺	氵 名
活	氵 舌
洽	氵 合
派	氵 厂 氏
洿	氵 夸
浀	氵 曲
流	氵 亠 厶 川
浂	氵 关
净	冫 争
浖	氵 寽
浗	氵 求
浘	氵 尾
浙	氵 折
浚	氵 夋
浛	氵 含
浜	氵 兵
浝	氵 尨
浞	氵 足
浟	氵 攸
浠	氵 希
浡	氵 孛
浢	氵 豆
浣	氵 完
浤	氵 宏
浥	氵 邑
浦	氵 甫
浧	氵 呈
浨	氵 宋
浩	氵 告
浪	氵 良
浫	氵 罕
浬	氵 里
浭	氵 更
浮	氵 孚
浯	氵 吾
浰	氵 利
浱	氵 辰
浲	氵 夆
浳	氵 弋 肉
浴	氵 谷
浵	氵 彤
浶	氵 牢
海	氵 每
浸	氵 彐 冖 又
浃	氵 夹
浺	氵 忡
浻	氵 冏
浼	氵 免
浽	氵 妥
浾	氵 赤
涁	氵 杉
涂	氵 余
涃	氵 困
涄	氵 甹
涅	氵 圼
涆	氵 旰
泾	氵 圣
消	氵 肖
涉	氵 步
涊	氵 忍
涋	氵 宊
涍	氵 孝
涎	氵 延
涏	氵 廷
涐	氵 我
涑	氵 束
涒	氵 君
涓	氵 肙
涔	氵 岑
涕	氵 弟
涖	氵 位
涚	氵 兑
涘	氵 矣
涙	氵 戻
渎	氵 卖
涪	氵 咅
涫	氵 官
涬	氵 幸
涭	氵 受
涮	氵 刷
涯	氵 厓
涰	氵 叕
液	氵 夜
涳	氵 空
涴	氵 宛
涵	氵 函
涶	氵 垂
涸	氵 固
涹	氵 委
涺	氵 居
涻	氵 舍
凉	冫 京
涽	氵 昏
涾	氵 沓
涿	氵 豖
淁	氵 妾
淂	氵 日 一 寸
淃	氵 卷
淄	氵 甾
淅	氵 析
淆	氵 肴
淇	氵 其
淈	氵 屈
淉	氵 果
淊	氵 臽
淋	氵 林
淌	氵 尚
淍	氵 周
淎	氵 奉
淏	氵 昊
淐	氵 昌
淑	氵 叔
凄	冫 妻
淓	氵 芳
淔	氵 直
淕	氵 坴
淖	氵 卓
淗	氵 匊
淘	氵 匋
泪	氵 目
淛	氵 制
淜	氵 朋
淝	氵 肥
淞	氵 松
淟	氵 典
淠	氵 畀
淡	氵 炎
淢	氵 或
淣	氵 兒
淤	氵 於
渌	氵 录
淦	氵 金
淧	氵 宓
净	冫 争
淩	氵 夌
沦	氵 仑
淫	氵 爫 壬
淬	氵 卒
淭	户 木
淮	氵 隹
淯	氵 育
淰	氵 念
深	氵 罙
淲	氵 虎
淳	氵 享
淴	氵 忽
渊	氵 片 一 爿
涞	氵 来
混	氵 昆
清	氵 青
淹	氵 奄
浅	氵 戋
添	氵 忝
淼	水 水 水
淽	氵 芷
淾	金 水
淿	氵 帛
渀	氵 奔
渁	氵 水
渂	氵 旻
渃	氵 若
渄	氵 非
清	氵 青
渆	氵 并 刂
渇	氵 日 勹 匕
济	氵 齐
涉	氵 步
渒	氵 卑
渕	氵 关 刂
渘	氵 柔
涣	氵 奂
渚	氵 者
减	冫 咸
渜	氵 耎
渝	氵 俞
渞	氵 首
渟	氵 亭
渠	洰 木
渡	氵 度
沨	氵 风
渣	氵 查
渤	氵 勃
渥	氵 屋
涡	氵 呙
渧	氵 帝
渨	氵 畏
渪	氵 禹
渫	氵 枼
测	氵 则
渭	氵 胃
渮	氵 荷
港	氵 巷
渰	氵 弇
渱	氵 虹
渲	氵 宣
渳	氵 弭
渴	氵 曷
渵	氵 苗
渶	氵 英
渷	氵 兗
游	氵 斿
渹	氵 訇
渺	氵 目 少
渻	氵 省
渼	氵 美
渽	氵 哉
浑	氵 军
渿	氵 奈
湀	氵 癸
湁	氵 拾
湂	氵 咢
湃	氵 拜
湄	氵 眉
湅	氵 柬
湆	氵 音
湇	氵 立 肉
湈	氵 某
湉	氵 恬
凑	冫 奏
湌	氵 食
湍	氵 耑
湎	氵 面
湐	氵 柏
湑	氵 胥
湒	氵 咠
湓	氵 盆
湔	氵 前
湕	氵 建
湖	氵 胡
湗	氵 封
湘	氵 相
湙	氵 奕
湚	氵 胤
湛	氵 甚
湜	氵 是
湝	氵 皆
浈	氵 贞
湟	氵 皇
湠	氵 炭
湡	氵 禺
湢	氵 畐
湣	氵 昬
湤	氵 施
湥	氵 突
湦	氵 星
涌	氵 甬
湨	氵 狊
湩	氵 重
湫	氵 秋
湬	秋 水
湮	氵 垔
汤	氵 弓 丿 丿
湰	氵 夂 一 生
湱	氵 砉
湲	氵 爰
湳	氵 南
湴	氵 並
湵	氵 羑
湶	氵 泉
湷	氵 春
湸	氵 亮
湹	氵 厘
湺	氵 保
湻	氵 亯
湼	氵 臼 工
湽	氵 甾 一
满	氵 艸 两
溆	氵 叙
沩	氵 为
溉	氵 既
泼	氵 发
溎	氵 桂
溏	氵 唐
源	氵 原
溒	氵 袁
溓	氵 兼
溔	氵 羔
溕	氵 冡
准	冫 隹
溗	氵 乘
溘	氵 盍
溙	氵 泰
溚	氵 荅
溛	氵 窊
溜	氵 留
沟	氵 勾
溞	氵 蚤
溟	氵 冥
溠	氵 差
溢	氵 益
溥	氵 尃
溦	氵 山 兀 攵
溧	氵 栗
溨	氵 栽
溪	氵 奚
温	氵 昷
溬	氵 羗
溭	氵 畟
浉	氵 师
溯	氵 朔
溱	氵 秦
溲	氵 叟
涢	氵 员
溴	氵 臭
溵	氵 殷
溶	氵 容
溷	氵 圂
溸	氵 素
溹	氵 索
溺	氵 弱
溻	氵 日 羽
湿	氵 显
溽	氵 辱
溾	氵 鬼
溿	氵 畔
滀	氵 畜
滁	氵 除
滂	氵 旁
滃	氵 翁
沧	氵 仓
灭	一 火
滆	氵 鬲
滇	氵 真
滈	氵 高
滉	氵 晃
滋	氵 兹
涤	氵 条
滍	氵 蚩
荥	艸 冖 水
滏	氵 釜
滑	氵 骨
滒	氵 哥
滓	氵 宰
滔	氵 舀
滕	氵 丷 夫 水
滖	氵 衰
滘	氵 冖 八 工 口
汇	氵 匚
滛	氵 爫 缶
滜	氵 皋
泷	氵 龙
滣	氵 唇
滫	氵 脩
沪	氵 户
滮	氵 彪
滞	氵 带
滰	氵 竟
滱	氵 寇
渗	氵 参
滳	氵 商
滴	氵 啇
滵	氵 密
滶	氵 敖
卤	卜 囗 乂
浒	氵 许
滹	氵 虖
滺	氵 悠
浐	氵 产
滼	氵 梵
滽	氵 庸
滚	氵 衮
满	氵 艹 两
漀	殸 水
渔	氵 鱼
漂	氵 票
漃	氵 寂
漄	氵 崖
漅	氵 巢
漆	氵 桼
漇	氵 徙
漈	氵 祭
漉	氵 鹿
溇	氵 娄
漋	氵 隆
漌	氵 堇
漎	氵 從
漏	氵 屚
溉	氵 既
漓	氵 离
演	氵 寅
漕	氵 曹
漖	氵 教
漗	氵 悤
漘	氵 脣
沤	氵 区
漛	氵 丷 夫 水
漜	氵 埜
漝	氵 習
漟	氵 堂
漠	氵 莫
汉	氵 又
涟	氵 连
漤	氵 婪
漥	氵 穴 圭
漦	未 攵 厂 水
漧	氵 乾
漨	氵 逢
漩	氵 旋
漪	氵 犭 奇
漫	氵 曼
渍	氵 责
漭	氵 莽
漮	氵 康
漯	氵 累
漰	氵 崩
漱	氵 欶
涨	氵 张
漳	氵 章
漴	氵 崇
漵	氵 敘
漶	氵 患
漷	氵 郭
渐	氵 斩
漹	氵 焉
漺	氵 爽
漻	氵 翏
漼	氵 崔
漽	氵 犀
漾	氵 羕
浆	丬 夕 水
潀	氵 眾
颍	匕 水 页
潂	氵 山 並
潃	氵 彳 攵 肉
潄	氵 敕
灌	氵 雚
潊	氵 敍
潌	氵 窒
潎	氵 敝
潏	氵 矞
潐	氵 焦
泼	氵 发
潒	氵 象
潓	氵 惠
洁	氵 吉
潖	氵 琶
潗	氵 集
潘	氵 番
沩	氵 为
潜	氵 替
潝	氵 翕
潞	氵 路
潟	氵 臼 勹 灬
潠	氵 巽
潡	氵 敦
潢	氵 黄
润	氵 闰
潥	氵 粟
潦	氵 尞
潧	氵 曾
潨	氵 衆
潩	氵 異
潪	氵 智
潫	氵 絭
潭	氵 覃
潮	氵 朝
浔	氵 寻
溃	氵 贵
潲	氵 稍
潳	氵 屠
潵	氵 散
潶	氵 黑
滗	氵 笔
潸	氵 木 木 月
潹	氵 森
潺	氵 孱
潻	氵 黍
潼	氵 童
潽	氵 普
潾	氵 粦
涠	氵 围
涩	氵 刃 止
澁	氵 歮
澂	氵 彳 山 一 王 攵 徴
澄	氵 登
浇	氵 尧
涝	氵 劳
澈	氵 育 攵
澉	氵 敢
澊	氵 尊
澋	氵 景
澌	氵 斯
澍	氵 尌
澎	氵 彭
澏	氵 喦
沄	氵 云
澑	氵 畱
澓	氵 復
澔	氵 皓
涧	氵 间
澘	氵 林 日
澙	氵 舃
澞	氵 虞
渑	氵 黾
澡	氵 品 木
澣	氵 幹
泽	氵 又 二 丨
澥	氵 解
滪	氵 预
澧	氵 豊
澨	氵 筮
泶	小 冖 水
澪	氵 零
澭	氵 雍
浍	氵 会
澯	氵 粲
淀	氵 定
澳	氵 奥
澴	氵 睘
澵	氵 新
澶	氵 亶
澷	氵 曰 罒 方
澸	氵 感
澹	氵 詹
澺	氵 意
澻	氵 遂
澼	氵 辟
澽	氵 豦
澿	氵 禁
激	氵 敫
浊	氵 虫
濂	氵 廉
浓	氵 农 脓
濅	氵 宀 帚 又
濈	氵 戢
濉	氵 睢
濋	氵 楚
濌	重 沓
濍	氵 葱
濎	氵 鼎
濐	氵 暑
濓	氵 亷
沵	氵 尔
湿	氵 显
濖	氵 署
濗	氵 幕
泞	氵 宁
溁	氵 荣
蒙	艸 冡
浕	氵 尽
濝	氵 綦
濞	氵 鼻
济	氵 齐
濠	氵 豪
濡	氵 需
濢	氵 翠
濣	氵 斡
涛	氵 寿
濥	氵 夤
濨	氵 慈
濩	氵 蒦
濪	氵 靘
滥	氵 监
濬	氵 睿
濭	氵 蓋
濯	氵 翟
潍	氵 维
滨	氵 宾
濲	氵 穀
潜	氵 替
溅	氵 贱
泺	氵 乐
滤	氵 虑
沋	氵 尤
瀁	氵 養
滢	氵 莹
渎	氵 卖
泻	氵 写
沈	氵 冘
渖	氵 审
瀌	氵 麃
瀍	氵 廛
瀎	氵 蔑
浏	氵 文 刂
瀐	氵 韯
瀑	氵 暴
瀓	氵 徵
濒	氵 频
瀖	氵 霍
泸	氵 卢
瀚	氵 翰
瀛	氵 嬴
瀜	氵 融
沥	氵 历
瀞	氵 静
潇	氵 肃
潆	氵 萦
瀣	氵 韰
瀤	氵 褱
瀥	氵 翯
潴	氵 猪
泷	氵 龙
濑	氵 赖
瀪	敏 泉
瀫	氵 縠
弥	弓 尔
瀱	氵 罽
潋	氵 敛
瀳	氵 薦
瀵	氵 糞
瀷	氵 翼
瀸	氵 韱
瀹	氵 龠
瀺	氵 毚
瀻	氵 戴
瀼	氵 襄
瀽	氵 蹇
澜	氵 阑
瀿	氵 繁
灀	氵 霜
灂	氵 爵
灃	氵 豐
滠	氵 聂
灅	氵 壘
灈	氵 瞿
灉	氵 雝
灊	氵 鬵
灌	氵 雚
滟	氵 艳
洒	氵 西
滟	氵 艳
灖	氵 靡
灗	氵 蟺
滩	氵 难
灏	氵 颢
灞	氵 霸
灢	氵 囊
湾	氵 弯
滦	氵 栾
灥	泉 泉 泉
滟	氵 艳
灩	氵 豔
火	丷 人
灬	丶 丶 丶 丶
灮	火 儿
灰	一 丿 火
灱	火 刀
灲	火 刂
灴	火 工
灶	火 土
灷	火 廾
灸	久 火
灹	火 乇
灺	火 也
灻	土 火
灼	火 勺
灾	宀 火
炁	旡 灬
炂	火 公
炃	分 火
炄	火 丑
炅	日 火
炆	火 文
炇	火 攵
炈	火 殳
炊	火 欠
炋	火 不
炌	火 介
炍	火 反
炎	火 火
炏	火 火
炐	火 丰
炑	火 木
炒	火 少
炓	火 斗
炔	火 夬
炕	火 亢
炗	廿 火
炘	火 斤
炙	月 火
炛	火 化
炟	火 旦
炠	火 甲
炡	火 正
炢	火 术
炣	火 可
炤	火 召
炥	火 弗
炦	火 犮
炧	火 丿 一 也
炨	火 它
炩	火 令
炪	火 出
炫	火 玄
炬	火 巨
炭	山 厂 火
炮	火 包
炯	火 冋
炰	包 灬
炱	台 火
炲	火 台
炳	火 丙
炴	火 央
炵	火 冬
炶	火 占
炷	火 主
炸	火 乍
为	丶 丿 ㇆ 丶
炻	火 石
炾	火 兄
烀	火 乎
烄	火 交
烅	火 血
烆	火 行
烇	火 全
烈	列 灬
烉	刀 冂 八 火
烊	火 羊
烋	休 灬
烌	火 休
烍	火 先
烎	开 火
乌	勹 ㇉ 一
烐	火 舟
烑	火 兆
烒	火 式
烓	火 圭
烔	火 同
烕	戊 一 火
烖	土 戈 火
烗	火 亥
烘	火 共
烙	火 各
烚	火 合
烜	火 亘
烝	丞 灬
烞	火 朴
烠	火 有
烡	火 共
烢	火 宅
烣	火 灰
烤	火 考
烯	火 希
烰	火 孚
烱	火 冏
烲	折 火
烳	火 甫
烃	火 圣
烵	火 勺
烶	火 廷
烷	火 完
烸	火 每
烹	亨 灬
烺	火 良
烻	火 延
烼	火 豕
烽	火 夆
烾	炎 土
烿	火 彤
焀	火 谷
焂	攸 火
焃	火 赤
焄	君 灬
焅	火 告
焆	火 肙
焇	火 肖
焈	户 已
焉	正 一 勹 灬
焊	火 旱
焌	火 夋
焍	火 弟
焎	折 灬
焏	了 口 又 灬
焐	火 吾
焓	火 含
焰	火 臽
焗	火 局
焙	火 咅
焚	林 火
焜	火 昆
焝	火 昏
焞	火 享
焟	火 昔
焠	火 卒
无	一 尢
焢	火 空
焣	取 灬
焤	府 火
焥	火 宛
焦	隹 灬
焧	火 忩
焨	火 冐
焩	火 朋
焪	火 穹
焫	火 芮
焬	火 易
焮	火 欣
焯	火 卓
焰	火 臽
焱	火 火 火
焲	火 夜
焳	火 隹
焴	火 育
焵	火 岡
然	月 犬 灬
焷	火 卑
焸	日 日 火
焺	火 昇
焻	火 昌
烧	火 尧
煁	火 甚
煂	火 革
煃	火 奎
煄	火 重
煅	火 段
煆	火 叚
炼	火 东 一
煊	火 宣
煋	火 星
煌	火 皇
煍	火 秋
煎	前 灬
煏	火 畐
煐	火 英
煑	者 火
炜	火 韦
煓	火 耑
煔	炎 占
煕	巸 灬
煖	火 爰
煗	火 耎
煘	火 咸
烟	火 因
煚	昛 火
煛	目 目 火
煜	火 日 立
煝	火 眉
煞	刍 攵 灬
煟	火 胃
煠	火 枼
煡	火 建
茕	艸 冖 卂
煣	火 柔
煤	火 某
焕	火 奂
煦	昫 灬
照	日 召 灬
煨	火 畏
烦	火 页
煪	火 酋
煫	火 丷 豕
炀	火 弓 丿 丿
煭	巛 列 灬
煮	者 灬
煰	火 品
煲	保 火
煳	火 胡
煵	火 南
煸	火 扁
煹	火 冓
煺	火 退
煻	火 唐
煼	火 芻
煽	火 扇
煾	火 恩
煿	火 尃
熀	火 晃
熁	火 脅
熄	火 息
煴	火 昷
熆	火 盍
熇	火 高
熈	丿 熙
熊	能 灬
熋	能 火
熎	爫 缶
熏	丿 一 里 丷 火
熐	火 冥
熑	火 兼
荧	艸 冖 火
熓	火 烏
熔	火 容
炝	火 仓
熘	火 留
熙	巸 灬
熛	火 票
熜	火 悤
熝	火 鹿
熞	火 堅
熟	孰 灬
熠	火 習
熢	火 逢
熣	火 崔
熤	火 翌
熥	火 通
熦	火 雀
熨	尉 火
熩	火 扈
熪	火 移
熫	火 庶
熬	敖 火
熭	彗 火
熮	火 翏
熯	火 革 大
热	执 灬
颎	匕 火 页
熳	火 曼
熵	火 商
熶	火 最
熷	火 曾
熸	火 朁
熹	喜 灬
熺	火 喜
熻	火 翕
熼	火 異
炽	火 只
熿	火 黄
烨	火 华
燂	火 覃
燃	火 然
燄	臽 炎
燅	埶 炎
燇	火 尊
灯	火 丁
炖	火 屯
燊	火 火 火 木
燋	火 焦
燍	火 斯
燎	火 尞
燏	火 矞
燐	火 粦
燑	火 童
烧	火 尧
燓	木 爻 木 火
燔	火 番
燕	廿 北 口 灬
烫	汤 火
燚	火 火 火 火
燛	臦 火
焖	火 闷
营	艹 冖 吕
燷	火 禀
燥	火 喿
灿	火 山
燧	火 遂
燩	火 敫
燪	火 葱
燫	火 廉
毀	臼 土 殳
烛	火 虫
燮	火 言 火 又
燯	火 零
燱	火 意
燳	火 照
烩	火 会
燸	火 需
燹	豕 豕 火
燺	火 槀
燻	火 熏
烬	火 尽
燽	火 壽
焘	寿 灬
燿	火 翟
爀	火 赫
爂	臼 同 冖 火
爅	火 墨
爆	火 暴
爊	火 麃
爋	火 勳
烁	火 乐
炉	火 户
爑	火 蕉
爒	炙 尞
爔	火 羲
爕	火 言 火 火
爗	火 曅
爙	火 襄
爚	火 火 龠
烂	火 兰
爝	火 爵
爞	火 虫 虫 虫
爟	火 雚
爡	火 蠆
爢	靡 灬
爨	臼 同 冖 林 大 火
爪	厂 丨 乀
爫	丿 丶 丶 丶
爬	爪 巴
争	爫 彐 亅 爭
爮	爪 包
爯	爫 冉
爰	爫 一 友
为	丶 丿 ㇆ 丶
爴	國 爪
爵	爫 肀 爭
父	八 乂
爸	父 巴
爹	父 多
爷	父 卩
爻	乂 乂
爼	爻 且
爽	大 乂 乂 乂 乂
尔	丿 乛 亅 八
爿	丨 一 丨 一 丿 
床	广 木
牁	爿 可
牂	爿 羊
牃	爿 枼
牅	爿 庸
墙	土 啬
片	丄 丿 ㇆
版	片 反
牉	片 半
牊	片 召
牌	片 卑
牎	片 怱
牏	片 俞
牐	片 臿
牑	片 扁
牒	片 枼
牓	片 旁
牔	片 尃
牕	片 悤
牖	片 戶 甫
牍	片 卖
牙	丅 一 亅 丿
牚	尚 牙
牛	丿 一 十
牜	丿 十 丿
牝	牜 匕
牞	牜 力
牟	厶 牛
牠	牜 也
牡	牜 土
牢	宀 牛
牣	牜 刃
牤	牜 亡
牥	牜 方
牧	牜 攵
牨	牜 亢
物	牜 勿
牪	牛 牛
牫	牜 戈
牬	牜 丿 ㇉ 丨 丿
牭	牜 四
牮	代 牛
牯	牜 古
牰	牜 由
牱	牜 可
牲	牜 生
牳	牜 母
牴	牜 氐
牶	𠔉 牛
牷	牜 全
牸	牜 字
特	牜 寺
牻	牜 尨
牵	大 冖 牛
牾	牜 吾
牿	牜 告
犀	尸 二 丨 二 牛
犁	利 牛
犂	禾 丿 刀 牛
犃	牜 咅
犄	牜 奇
犆	牜 直
犇	牛 牛 牛
犈	牜 卷
犉	牜 享
犋	牜 具
犌	牜 叚
犍	牜 建
犎	封 牛
犏	牜 扁
犐	牜 科
犑	牜 狊
犒	牜 高
犓	牜 芻
犕	牜 艹 厂 用
荦	艸 冖 牛
犗	牜 害
犘	麻 牛
犚	尉 牛
犛	未 攵 厂 牛
犜	牜 敦
犝	牜 童
犟	强 牛
犊	牜 卖
犣	牜 巤
犥	牜 麃
犦	牜 暴
牺	牜 西
犨	隹 隹 牛
犩	魏 牛
犪	牜 夔
犫	隹 言 隹 牛
犬	大 丶
犭	丶 亅 丿
犮	一 丿 丶 乂
犯	犭 卩
犰	犭 九
犱	犭 丸
犲	犭 才
犳	犭 勺
犴	犭 干
犵	犭 乞
犺	犭 亢
犻	犭 巿
犼	犭 孔
犽	犭 牙
犾	犭 犬
犿	犭 卞
状	丬 犬
狁	犭 允
狂	犭 王
狃	犭 丑
狄	犭 火
狅	犭 壬
狆	犭 中
狇	犭 木
狉	犭 丕
狊	目 犬
狋	犭 示
狌	犭 生
狍	犭 包
狎	犭 甲
狏	犭 丿 一 也
狐	犭 瓜
狑	犭 令
狒	犭 弗
狓	犭 皮
狔	犭 尼
狕	犭 幼
狖	犭 穴
狗	犭 句
狘	犭 戉
狙	犭 且
狚	犭 旦
狛	犭 白
狜	犭 古
狟	犭 亘
狠	犭 艮
狡	犭 交
狢	犭 各
狣	犭 兆
狤	犭 吉
狥	犭 旬
狦	犭 冊 一
狧	犭 舌
狨	犭 戎
狩	犭 守
狪	犭 同
狫	犭 老
狳	犭 余
狴	犭 比 土
狵	犭 尨
狶	犭 希
狷	犭 肙
狸	犭 里
狭	犭 夹
狺	犭 言
狻	犭 夋
狼	犭 良
狈	犭 贝
狾	犭 折
狿	犭 延
猀	犭 沙
猁	犭 利
猂	犭 旱
猄	犭 京
猅	犭 非
猆	非 犬
猇	犭 虎
猈	犭 卑
猉	犭 其
猊	犭 兒
猋	犬 犬 犬
猏	犭 肩
猐	犭 羌
猑	犭 昆
猒	日 肉 犬
猓	犭 果
猔	犭 宗
猖	犭 昌
猗	犭 奇
猘	犭 制
狰	犭 争
猚	犭 隹
猛	犭 孟
猜	犭 靑
猝	犭 卒
猞	犭 舍
猢	犭 胡
猣	犭 凶 八 夕
猤	犭 癸
猥	犭 畏
猨	犭 爰
猩	犭 星
猭	犭 彖
猯	犭 耑
猰	犭 契
猱	犭 柔
猲	犭 葛
猳	犭 叚
猴	犭 侯
猵	犭 扁
犹	犭 尤
猷	酋 犬
猸	犭 眉
猹	犭 查
狲	犭 孙
猼	犭 尃
猽	犭 冥
猾	犭 骨
猿	犭 袁
獀	犭 叟
犸	犭 马
獂	犭 原
呆	口 木
狱	犭 讠 犬
狮	犭 师
獆	犭 皋
獈	犭 益
獉	犭 秦
獋	犭 臯
獌	犭 曼
獍	犭 竟
奖	丬 夕 大
獐	犭 章
獒	敖 犬
獓	犭 敖
獔	犭 皐
獕	犭 崔
獗	犭 厥
獘	敝 犬
獙	犭 敝
獚	
獛	犭 菐
獜	犭 粦
獝	犭 矞
獞	犭 童
獠	犭 尞
獡	犭 舄
獥	犭 敫
獦	犭 葛
獧	犭 睘
独	犭 虫
狯	犭 会
猃	犭 佥
獬	犭 解
狝	犭 尔
獯	犭 熏
狞	犭 宁
获	艸 犭 犬
獳	犭 需
獴	犭 蒙
猎	犭 昔
犷	犭 广
兽	丷 田 一 口
獭	犭 赖
献	南 犬
猕	犭 弥
獽	犭 襄
獿	犭 夒
猡	犭 罗
玃	犭 矍
玄	亠 幺
玅	玄 少
玆	玄 玄
率	玄 冫 丶 丶 十
玈	玄 丿 一 氏
玉	王 丶
玊	王 丶
王	一 一 丨 一
玌	王 乚
玍	午 一
玎	王 丁
玏	王 力
玐	王 八
玒	王 工
玓	王 勺
玔	王 川
玕	王 干
玖	王 久
玗	王 于
玘	王 己
玜	王 公
玝	王 午
玞	王 夫
玟	王 文
玠	王 介
玡	王 牙
玢	王 分
玣	王 卞
玤	王 丰
玥	王 月
玦	王 夬
玧	王 允
玨	王 王
玩	王 元
玪	王 今
玫	王 攵
玬	王 丹
玭	王 比
玲	王 令
玳	王 代
玴	王 世
玵	王 甘
玶	王 平
玷	王 占
玸	王 包
玹	王 玄
玻	王 皮
玼	王 此
玽	王 句
玾	王 甲
玿	王 召
珀	王 白
珁	王 瓦
珂	王 可
珃	王 冉
珄	王 生
珅	王 申
珆	王 台
珇	王 且
珈	王 加
珉	王 民
珋	王 卯
珌	王 必
珍	王 人 彡
珎	王 尓
珏	王 玉
珒	王 聿
珓	王 交
珔	王 存
珕	王 劦
珖	王 光
珗	王 先
珘	王 舟
珙	王 共
珚	王 因
珛	王 有
珜	王 羊
珝	王 羽
珞	王 各
珟	王 夙
珠	王 朱
珡	王 王 人
珢	王 艮
珣	王 旬
珤	王 缶
珥	王 耳
珦	王 向
珧	王 兆
珨	王 合
珩	王 行
珪	王 圭
珫	王 充
珬	王 戌
班	玉 刂 王
珮	玉 几 帀
珳	王 彣
珴	王 我
珵	王 呈
珶	王 弟
珷	王 武
珸	王 吾
珹	王 成
珺	王 君
珻	王 每
珽	王 廷
现	王 见
珿	王 足
琀	王 含
琁	王 丿 一 疋
琂	王 言
球	王 求
琄	王 肙
理	王 里
琇	王 秀
琈	王 孚
琉	王 亠 厶 川
琊	王 邪
琋	王 希
琌	王 岑
琍	王 利
琓	王 完
琔	王 定
琕	王 卑
琗	王 卒
琘	王 昏
琙	王 或
琚	王 居
琛	王 罙
琝	王 旻
琞	明 玉
琟	王 隹
琠	王 典
琡	王 叔
琢	王 豖
琣	王 咅
琤	王 爭
琥	王 虎
琦	王 奇
琨	王 昆
琩	王 昌
琪	王 其
琫	王 奉
琬	王 宛
琭	王 彔
琮	王 宗
琯	王 官
琰	王 炎
琱	王 周
琲	王 非
琳	王 林
琴	王 王 今
琵	王 比
琶	王 巴
琷	王 羌
琸	王 卓
琹	王 王 木
珐	王 法 琺
琽	王 者
琾	王 界
珲	王 军
瑀	王 禹
瑁	王 冒
瑂	王 眉
瑄	王 宣
瑅	王 是
瑆	王 星
瑇	王 毒
瑈	王 柔
瑉	王 昬
瑊	王 咸
玮	王 韦
瑌	王 耎
瑎	王 皆
瑏	王 穿
瑐	王 前
瑑	王 彖
玚	王 弓 丿 丿
瑓	王 柬
瑔	王 泉
瑕	玉 叚
瑖	王 段
瑗	王 爰
瑘	王 耶
瑙	王 巛 囟
瑚	王 胡
瑛	王 英
瑜	王 俞
瑝	王 皇
瑞	王 耑
瑟	王 必
瑠	王 留
瑢	王 容
琐	王 小 贝
瑶	王 爫 缶
瑥	王 昷
瑧	王 秦
瑨	王 晉
莹	艹 冖 玉
玛	王 马
瑫	王 舀
瑬	流 玉
瑭	王 唐
瑮	王 栗
琅	王 良
瑰	王 鬼
瑱	王 真
玱	王 仓
瑳	王 差
瑴	士 冖 一 王 殳
瑵	王 蚤
瑹	王 荼
瑺	王 常
瑾	王 堇
瑿	殹 玉
璀	王 崔
璁	王 悤
璂	王 基
璃	王 离
璄	王 竟
璅	王 巢
璆	王 翏
璇	王 旋
璈	王 敖
琏	王 连
璋	王 章
璌	王 寅
璏	王 彘
璐	王 路
璒	王 登
璔	王 曾
璖	王 渠
璘	王 粦
璙	王 尞
璚	王 矞
璜	
璞	王 菐
璟	王 景
璠	王 番
琎	王 进
璢	王 畱
玑	王 几
璥	王 敬
瑷	王 爱
璧	辟 玉
璨	王 粲
璩	王 豦
璪	王 喿
珰	王 当
璬	王 敫
璮	王 亶
环	王 不
璱	王 瑟
璲	王 遂
玙	王 与
璷	王 敷
瑸	王 宾
璻	王 翠
玺	尔 玉
璿	王 睿
瓀	王 需
瓁	王 蒦
瓃	王 畾
瓈	王 黎
琼	王 京
瓌	王 褱
珑	王 龙
璎	王 婴
瓖	王 襄
瓗	王 巂
瓘	王 雚
瓒	王 赞
瓛	王 獻
瓜	爪 一 丶
瓝	瓜 勺
瓞	瓜 失
瓟	瓜 包
瓠	夸 瓜
瓡	幸 瓜
瓢	票 瓜
瓣	辛 瓜 辛
瓤	襄 瓜
瓥	瓜 豕 虫 虫
瓨	工 瓦
瓪	瓦 反
瓫	分 瓦
瓬	方 瓦
瓭	冘 瓦
瓮	公 瓦
瓳	古 瓦
瓴	令 瓦
瓵	台 瓦
瓶	并 瓦
瓷	次 瓦
瓹	肙 瓦
瓺	镸 瓦
瓻	希 瓦
瓽	尚 瓦
瓾	委 瓦
瓿	咅 瓦
甀	垂 瓦
瓶	并 瓦
甂	扁 瓦
甃	秋 瓦
甄	垔 瓦
甆	兹 瓦
甈	臬 瓦
甉	兼 瓦
甋	啇 瓦
瓯	区 瓦
甍	艸 网 冖 瓦
甏	彭 瓦
甐	粦 瓦
甑	曾 瓦
甓	辟 瓦
甔	詹 瓦
甕	雍 瓦
甗	虍 鬲 瓦
甘	廿 一
甙	甘 弋
甚	其 乚
甛	甘 舌
甜	舌 甘
甝	虎 甘
甞	尚 甘
生	丿 三 丨
甠	日 生
甡	生 生
产	立 丿
产	立 丿
甤	豕 生
甥	生 男
甦	更 生
甧	生 生 月
用	冂 十 一
甩	月 乚
甪	丶 用
甫	一 丶 用
甬	龴 用
甭	不 用
甮	勿 用
宁	宀 丁
田	囗 十
由	囗 十
甲	囗 十
申	囗 十
甴	口 丄
甶	丶 田
男	田 力
甸	勹 田
甹	由 丂
町	田 丁
甼	田 丁
甽	田 川
甾	巛 田
甿	田 亡
畀	田 丌
畁	由 丌
畂	田 久
畃	申 勺
留	卯 田
畆	亩 厶
畇	田 匀
畈	田 反
畉	田 夫
畊	田 井
畋	田 攵
界	田 介
畍	田 介
畎	田 犬
畐	一 口 田
畑	火 田
畒	亩 人
畔	田 半
畕	田 田
畖	田 瓜
畗	丶 畐 田
畘	田 冉
留	卯 田
畚	厶 大 田
畛	田 人 彡
畜	玄 田
亩	亠 田
畞	十 田 久
畟	田 八 夂
畡	田 亥
毕	比 十
畣	人 畐
畤	田 寺
略	田 各
畦	田 土 土
畧	田 各
畨	米 田
番	采 田
画	一 由 凵
畬	余 田
畭	田 余
畮	田 母
畯	田 夋
异	己 廾
畱	丣 田
畲	余 田
畳	田 冝
画	一 由 凵
当	小 彐
畷	田 叕
畸	田 奇
畹	田 宛
畺	三 田 田
畻	田 𠔉 土
畽	田 重
畾	田 田 田
畿	幾 田
疀	甾 疌
疁	田 翏
疃	田 童
疄	田 粦
疅	田 畺
疆	弓 土 畺
畴	田 寿
疈	畐 丶 丿 畐
疉	畾 宀 彑
叠	叒 冝
疋	乛 卜 人
疌	一 肀 卜 人
疍	疋 旦
疎	疋 束
疏	疋 巟
疐	十 冖 田 疋
疑	匕 矢 龴 疋
疒	丶 一 丬
疓	疒 乃
疔	疒 丁
疕	疒 匕
疘	疒 工
疙	疒 乞
疚	疒 久
疛	疒 寸
疜	疒 下
疝	疒 山
疞	疒 亏
疢	疒 火
疣	疒 尤
疤	疒 巴
疥	疒 介
疦	疒 夬
疧	疒 氏
疨	疒 牙
疩	疒 卆
疪	疒 必
疫	疒 殳
疰	疒 主
疱	疒 包
疲	疒 皮
疳	疒 甘
疴	疒 可
疵	疒 此
疶	疒 世
疷	疒 氐
疸	疒 旦
疹	疒 人 彡
疺	疒 乏
疻	疒 只
疼	疒 冬
疽	疒 且
疾	疒 矢
疿	疒 弗
痀	疒 句
痁	疒 占
痂	疒 加
痃	疒 玄
痄	疒 乍
病	疒 丙
痆	疒 尼
症	疒 正
痊	疒 全
痋	疒 虫
痌	疒 同
痍	疒 夷
痎	疒 亥
痏	疒 有
痐	疒 回
痑	疒 多
痓	疒 至
痔	疒 寺
痕	疒 艮
痗	疒 每
痘	疒 豆
痉	疒 圣
痚	疒 孝
痛	疒 甬
痜	疒 禿
痝	疒 尨
痞	疒 否
痟	疒 肖
痠	疒 夋
痡	疒 甫
痢	疒 利
痣	疒 志
痤	疒 坐
痥	
痦	疒 吾
痧	疒 沙
痩	疒 申 又
痬	疒 易
痭	疒 朋
痯	疒 官
痰	疒 炎
痱	疒 非
麻	广 林
痳	疒 林
痵	疒 季
痶	疒 典
痷	疒 奄
痸	疒 制
痹	疒 畀
痺	疒 卑
痻	疒 昏
痼	疒 固
痽	疒 隹
痾	疒 阿
痿	疒 委
瘀	疒 於
瘁	疒 卒
痖	疒 亚
瘃	疒 豖
瘄	疒 昔
瘇	疒 重
瘈	疒 契
瘉	疒 俞
瘊	疒 侯
疯	疒 风
瘌	疒 剌
疡	疒 弓 丿 丿
瘎	疒 甚
瘏	疒 者
瘐	疒 臾
痪	疒 奂
瘔	疒 苦
瘕	疒 叚
瘖	疒 音
瘙	疒 蚤
瘚	疒 欮
瘛	疒 恝
瘜	疒 息
瘝	疒 眔
瘞	疒 座
瘟	疒 昷
瘠	疒 脊
疮	疒 仓
瘢	疒 般
瘣	疒 鬼
瘤	疒 留
瘥	疒 差
瘦	疒 叟
疟	疒 匸 一
瘨	疒 真
瘩	疒 荅
瘭	疒 票
瘆	疒 参
瘯	疒 族
瘰	疒 累
瘗	疒 夹
疭	疒 从
瘳	疒 翏
瘴	疒 章
瘵	疒 祭
瘶	疒 欶
瘷	疒 敕
瘸	疒 加 肉
瘺	疒 屚
瘘	疒 娄
瘼	疒 莫
瘽	疒 堇
癀	
癁	疒 復
疗	疒 了
癃	疒 隆
癄	疒 焦
癅	疒 畱
痨	疒 劳
痫	疒 闲
瘅	疒 单
癊	疒 陰
癌	疒 品 山
癍	疒 斑
癏	疒 睘
愈	俞 心
癓	疒 微
癔	疒 意
癕	疒 雍
癖	疒 辟
癗	疒 雷
疠	疒 万
癙	疒 鼠
癚	疒 詹
癝	疒 禀
癜	疒 殿
瘪	疒 自 仑
痴	疒 知
痒	疒 羊
疖	疒 节
癥	疒 徵
疬	疒 历
癨	疒 霍
癞	疒 赖
癣	疒 鲜
瘿	疒 婴
瘾	疒 隐
癯	疒 瞿
痈	疒 用
瘫	疒 难
癫	疒 颠
癳	疒 纍
癸	癶 天
癹	癶 殳
发	丿 一 丿 又 丶
登	癶 豆
发	丿 一 丿 又 丶
白	丶 日
百	一 白
癿	白 乚
皀	白 匕
皁	白 十
皂	白 七
皃	白 儿
的	白 勺
皅	白 巴
皆	比 白
皇	白 王
皈	白 反
皉	白 此
皊	白 令
皋	白 大 十
皌	白 末
皍	白 匕 卩
皎	白 交
皏	白 并
皐	白 二 十 二
皒	白 我
皓	白 告
皔	白 旱
皕	百 百
皖	白 完
皗	白 周
皘	白 青
皙	析 白
皑	白 岂
皛	白 白 白
皜	白 高
皝	皇 光
皞	白 皋
皠	白 崔
皡	白 皐
皢	白 堯
皤	白 番
皥	白 臯
皦	白 敫
皨	皛 土
皩	皇 晃
皫	白 麃
皬	白 霍
皭	白 爵
皮	丿 支
皯	皮 干
皰	皮 包
皳	求 皮
皴	夋 皮
皵	昔 皮
皶	查 皮
皷	十 豆 皮
皲	军 皮
皲	皮 军
皱	刍 皮
皻	虘 皮
皼	壹 皮
皽	亶 皮
皿	冊 一
盀	卜 皿
盁	乃 皿
盂	于 皿
杯	木 不
盄	弔 皿
盅	中 皿
盆	分 皿
盇	太 皿
盈	夃 皿
盉	禾 皿
益	丷 一 八 皿
盋	犮 皿
盌	夗 皿
盍	去 皿
盎	央 皿
盒	合 皿
盓	汙 皿
盔	灰 皿
盕	汎 皿
盙	甫 皿
盚	求 皿
盛	成 皿
盗	次 皿
盝	彔 皿
盏	戋 皿
盟	明 皿
盠	彖 皿
尽	尺 冫
盢	畎 皿
监	丨 丨 丿 一 丶 皿
盘	舟 皿
盥	臼 水 皿
盦	今 酉 皿
卢	卜 尸
盩	幸 攵 皿
荡	艸 汤
盫	合 酉 皿
盬	臣 丿 一 古 皿
盭	幺 幸 攵 皿
目	囗 二
盯	目 丁
盰	目 干
盱	目 于
盲	目 亡
盳	目 亡
直	十 目 丨 一
盵	目 乞
盶	目 元
盷	目 勺
相	木 目
盹	目 屯
盺	目 斤
盻	目 兮
盼	目 分
盽	目 丰
盾	厂 十 目
盿	目 文
眀	目 月
省	少 目
眂	目 氏
眃	目 云
眄	目 丏
眅	目 反
眆	目 方
眇	目 少
眈	目 冘
眉	尸 丶 目
眊	目 毛
看	手 目
県	目 丨 一 小
眎	目 示
眏	目 央
眐	目 正
眑	目 幼
眒	目 申
眓	目 戉
眔	目 丨 八 八
眕	目 人 彡
眖	目 兄
眗	目 句
眘	大 丷 目
眙	目 台
眚	生 目
眛	目 未
眜	目 末
眝	目 宁
眞	匕 目 丨 一 八
真	直 八
眠	目 民
眡	目 氐
眢	夗 目
眣	目 失
眤	目 尼
眥	此 目
眦	目 此
眧	目 召
眨	目 乏
眩	目 玄
眪	目 丙
眫	目 半
眭	目 圭
眮	目 同
眰	目 至
眱	目 夷
眲	目 耳
眳	目 名
眴	目 旬
眵	目 多
眶	目 匡
眷	𠔉 目
眸	目 牟
眹	目 关
眺	目 兆
眻	目 羊
眼	目 艮
眽	目 厂 氏
众	人 人 人
眿	目 永
睂	仌 丨 厂 目
睃	目 夋
睄	目 肖
睅	目 旱
睆	目 完
睇	目 弟
睈	目 呈
睉	目 坐
睊	目 肙
睋	目 我
睌	目 免
睍	目 見
睎	目 希
困	囗 木
睒	目 炎
睓	目 典
睕	目 宛
睖	目 夌
睗	目 易
睘	罒 一 口 
睙	目 戾
睚	目 厓
睛	目 青
睁	目 争
睐	目 来
睟	目 卒
睠	目 卷
睡	目 垂
睢	目 隹
督	叔 目
睤	目 畀
睥	目 卑
睦	目 土 儿 土
睧	目 昏
睨	目 兒
睩	目 彔
睪	罒 幸
睫	目 疌
睬	目 采
睭	目 周
睮	目 俞
睯	敃 目
睰	目 若
睱	目 叚
睲	目 星
睳	目 奎
睶	目 春
睷	目 建
睸	目 眉
睹	目 者
睺	目 侯
睻	目 宣
睼	目 是
睽	目 癸
睾	丶 罒 幸
睿	卜 冖 一 八 人 目
瞀	敄 目
瞁	目 狊
瞂	盾 犮
瞃	目 盾
瞄	目 苗
瞅	目 秋
眯	目 米
瞈	目 翁
瞉	士 冖 一 目 殳
瞊	目 唐
瞋	目 真
瞌	目 去 皿
瞍	目 叟
瞎	目 害
瞏	罒 袁
瞐	目 目 目
瞑	目 冥
瞔	目 責
瞕	目 章
瞖	殹 目
眍	目 区
瞙	目 莫
瞚	目 寅
瞝	目 离
瞒	目 艹 两
瞟	目 票
瞠	目 堂
瞢	艸 网 冖 目
瞥	敝 目
瞦	目 喜
瞧	目 焦
瞨	目 菐
瞪	目 登
瞫	目 覃
瞬	目 舜
了	乛 亅
瞮	目 育 攵
瞰	目 敢
瞲	目 矞
瞳	目 童
瞵	目 粦
瞆	目 贵
瞸	目 葉
瞻	目 詹
睑	目 佥
瞽	鼓 目
瞾	目 目 空
瞿	目 目 隹
矀	目 微
矁	目 愁
矂	目 喿
矄	目 熏
矅	目 翟
矆	目 蒦
蒙	艸 冡
矈	目 臱
矍	目 目 隻
矎	目 夐
矏	目 臱
矐	目 霍
矒	目 瞢
眬	目 龙
矔	目 雚
矗	直 直 直
瞩	目 属
矛	予 丿
矜	矛 今
矝	矛 令
矞	矛 冏
矟	矛 肖
矠	矛 昔
矡	矛 矍
矢	丿 天
矣	厶 矢
矤	弓 矢
知	矢 口
矦	厃 矢
矧	矢 引
矨	矢 夭
矩	矢 巨
矪	矢 舟
矬	矢 坐
短	矢 豆
矮	矢 委
矫	矢 乔
矰	矢 曾
矱	矢 蒦
石	一 丿 口
矴	石 丁
矵	石 刂
矷	石 子
矸	石 干
矹	石 兀
矺	石 乇
矻	石 乞
矼	石 工
矽	石 夕
矾	石 凡
砂	石 少
砃	石 丹
砄	石 夬
砅	石 水
砆	石 夫
砇	石 文
砈	石 厄
砉	丰 石
砊	石 亢
砋	石 止
砌	石 切
砍	石 欠
砎	石 介
砏	石 分
砐	石 及
砑	石 牙
砒	石 比
砓	石 殳
研	石 开
砕	石 卆
砘	石 屯
砙	石 瓦
砝	石 去
砞	石 末
砟	石 乍
砠	石 且
砡	石 玉
砢	石 可
砣	石 它
砤	石 丿 一 也
砥	石 氐
砦	此 石
砧	石 占
砨	石 戹
砩	石 弗
砪	石 母
砫	石 主
砬	石 立
砭	石 乏
砮	奴 石
砯	石 氷
砰	石 平
砱	石 令
砲	石 包
砳	石 石
破	石 皮
砵	石 本
砶	石 白
砷	石 申
砸	石 匝
砹	石 艾
砼	石 仝
硂	石 全
硃	石 朱
硄	石 光
硅	石 圭
硆	石 合
硇	石 囟
硈	石 吉
硉	石 聿
硊	石 危
硋	石 亥
硌	石 各
硍	石 艮
硎	石 刑
硏	石 幵
硐	石 同
硑	石 并
硒	石 西
硔	石 共
硁	石 圣
硝	石 肖
硞	石 告
硟	石 延
硠	石 良
硡	石 宏
硢	石 余
硣	石 孝
硖	石 夹
硥	石 尨
硦	石 弄
硧	石 甬
砗	石 车
硩	折 石
硪	石 我
硫	石 巟
硬	石 更
硭	石 芒
砚	石 见
硰	沙 石
硱	石 困
硲	石 谷
硶	石 岑
硸	石 岸
硹	石 松
硺	石 豖
硼	石 朋
硽	石 奄
硾	石 垂
硿	石 空
棋	木 其
碂	石 宗
碃	石 青
碄	石 林
碅	石 囷
碆	波 石
碇	石 定
碈	石 昏
碉	石 周
碋	石 岢
碌	石 录
碎	石 卒
碏	石 昔
碐	石 夌
碑	石 卑
碒	石 金
碓	石 隹
碔	石 武
碕	石 奇
碗	石 宛
碘	石 典
碚	石 咅
碝	石 耎
碞	品 石
碟	石 世 木
碠	石 亭
碡	石 毒
碣	石 曷
碤	石 英
碥	石 扁
碦	石 客
碧	王 白 石
碨	石 畏
硕	石 页
碪	石 甚
碫	石 段
碬	石 叚
砀	石 弓 丿 丿
碮	石 是
碰	石 並
碱	石 咸
碲	石 帝
碳	石 炭
碴	石 查
碶	石 契
砜	石 风
碹	石 宣
确	石 角
碻	石 高
码	石 马
碾	石 展
碿	石 屑
磀	石 逆
磁	石 兹
磂	石 留
磃	石 虒
磄	石 唐
磅	石 旁
磆	石 骨
磇	石 囟 比
磈	石 鬼
磉	石 桑
磊	石 石 石
磋	石 差
磌	石 真
磍	石 害
磎	石 奚
磏	石 兼
磐	般 石
硙	石 岂
磓	石 追
磔	石 桀
磕	石 去 皿
磖	石 習
磘	石 爫 缶
磙	石 衮
砖	石 专
磜	石 祭
磝	石 敖
磞	石 崩
磟	石 翏
硵	石 卤
磡	石 甚 力
磢	石 爽
碜	石 参
磤	石 殷
磥	石 累
磦	石 票
碛	石 责
磨	麻 石
磩	石 戚
磪	石 崔
磬	殸 石
磭	石 脣
矶	石 几
磰	石 善
磲	石 渠
磳	石 曾
磴	石 登
磶	石 舄
磷	石 粦
磸	石 奠
磹	石 覃
磺	石 黄
磻	石 番
磼	石 集
硗	石 尧
磿	厤 石
礁	石 焦
礃	石 掌
硚	石 乔
礅	石 敦
硷	石 佥
礇	石 奧
礈	石 遂
礉	石 敫
礊	車 凵 殳 石
礌	石 雷
礍	石 葛
础	石 出
礓	石 畺
礔	石 辟
礕	辟 石
碍	石 㝵
礝	石 需
礞	石 蒙
炮	火 包
礠	石 慈
礡	石 蒪
礣	石 蔑
礤	石 蔡
矿	石 广
礧	石 畾
礨	畾 石
砺	石 厉
砾	石 乐
礬	木 爻 木 大 石
礭	石 霍
砲	石 包
砻	龙 石
礳	石 磨
礴	石 薄
礵	石 霜
礶	石 雚
示	二 小
礻	丶 乙 丨 丶
礽	礻 乃
社	礻 土
礿	礻 勺
祀	礻 巳
祁	礻 阝
祂	礻 也
祄	礻 介
祅	礻 夭
祆	礻 天
祇	礻 氏
祈	礻 斤
祉	礻 止
祊	礻 方
祋	礻 殳
祌	礻 中
祏	礻 石
祐	礻 右
祑	礻 失
祒	礻 召
祓	礻 犮
祔	礻 付
祕	礻 必
祖	礻 且
祗	礻 氐
祘	示 示
祙	礻 未
祚	礻 乍
祛	礻 去
祜	礻 古
祝	礻 兄
神	礻 申
祟	出 示
祠	礻 司
祡	此 示
祣	礻 丿 一 氏
祤	礻 羽
祥	礻 羊
祦	礻 吴
祧	礻 兆
票	襾 示
祩	礻 朱
祪	礻 危
祫	礻 合
祬	礻 至
祭	夗 示
祮	礻 吉
祰	礻 告
祱	
祲	礻 彐 冖 又
祳	礻 辰
祴	礻 戒
祵	礻 困
祶	礻 弟
祹	礻 匋
祺	礻 其
祻	礻 固
祼	礻 果
祽	礻 卒
祾	礻 夌
禄	礻 录
禁	林 示
禂	礻 周
禃	礻 直
禆	礻 卑
禇	礻 者
禉	礻 酋
禊	礻 契
禋	礻 垔
禌	礻 兹
祸	礻 呙
祯	礻 贞
福	礻 畐
禐	礻 爰
禑	礻 禺
禒	礻 彖
禔	礻 是
祎	礻 韦
禖	礻 某
禗	礻 思
禘	礻 帝
禚	礻 羔
禛	礻 眞
禝	礻 畟
禞	礻 高
禟	礻 唐
禠	礻 虒
祃	礻 马
禢	礻 日 羽
禤	礻 罒 羽
禥	礻 基
御	彳 卸
禧	礻 喜
禩	礻 異
禅	礻 单
禫	礻 覃
禭	礻 遂
礼	礻 乚
祢	礻 尔
祷	礻 寿
禳	礻 襄
禴	礻 龠
禸	冂 厶
禹	丿 口 冂 厶
禺	日 禸
禼	卜 口 乂 冂 厶
禽	人 离
禾	丿 木
秃	禾 几
秀	禾 乃
私	禾 厶
秂	禾 人
秄	禾 子
秅	禾 乇
秆	禾 干
秇	禾 丸
秈	禾 山
秉	禾 肀
秊	禾 千
秋	禾 火
秌	火 禾
秎	禾 分
秏	禾 毛
秐	禾 云
科	禾 斗
秒	禾 少
秓	禾 支
秔	禾 亢
秕	禾 比
秖	禾 氏
秗	禾 夭
秘	禾 必
秙	禾 古
秚	禾 半
秛	禾 皮
秜	禾 尼
秝	禾 禾
秞	禾 由
租	禾 且
秠	禾 丕
秡	禾 犮
秢	禾 令
秣	禾 末
秤	禾 平
秥	禾 占
秦	龹 禾
秧	禾 央
秨	禾 乍
秩	禾 失
秪	禾 氐
秫	禾 朮
秬	禾 巨
秭	禾 丿 ㇉ 丨 丿
秮	禾 台
秱	禾 同
秲	禾 寺
秳	禾 舌
秴	禾 合
秵	禾 因
秶	次 禾
秷	禾 至
秸	禾 吉
秹	禾 任
秺	禾 宅
移	禾 多
秼	禾 朱
秿	禾 甫
稀	禾 希
稁	亠 口 冂 禾
稂	禾 良
稃	禾 孚
稄	禾 夋
税	禾 兑
稆	禾 吕
稇	禾 困
稈	禾 旱
稉	禾 更
稊	禾 弟
程	禾 呈
稌	禾 余
稍	禾 肖
稑	禾 坴
稒	禾 固
稓	禾 昔
稔	禾 念
稕	禾 享
稖	禾 咅
稗	禾 卑
稘	禾 其
稙	禾 直
稚	禾 隹
稛	禾 困
棱	木 夌
稝	禾 朋
稞	禾 果
禀	亠 回 示
稠	禾 周
稡	禾 卒
稢	禾 或
稤	禾 京
稧	禾 契
稨	禾 扁
稩	禾 胃
稪	禾 复
稫	禾 畐
稬	禾 耎
稭	禾 皆
种	禾 中
稯	禾 凶 八 夂
稰	禾 胥
称	禾 尔
稻	禾 舀
稴	禾 兼
稵	禾 兹
稶	禾 彧
稷	禾 田 儿 夂
稸	禾 畜
稹	禾 真
稺	禾 屖
稻	禾 舀
稼	禾 家
稽	禾 尤 旨
稾	高 禾
稿	禾 高
谷	八 人 口
穁	禾 茸
穗	禾 惠
穄	禾 祭
穅	禾 康
穆	禾 白 小 彡
䅟	禾 参
穈	麻 禾
穉	禾 犀
穊	禾 既
穋	禾 翏
稣	鱼 禾
积	禾 只
颖	匕 禾 页
稳	禾 急
穐	禾 亀
穓	禾 異
穔	禾 黄
穕	禾 集
穗	禾 惠
穙	禾 菐
穛	禾 焦
穜	禾 童
穟	禾 遂
秾	禾 农
穑	禾 啬
秽	禾 岁
穣	禾 衣 八 井 一
穤	禾 需
稳	禾 急
获	艸 犭 犬
穞	禾 鲁
穮	禾 麃
穰	禾 襄
穱	禾 爵
穴	宀 八
穵	穴 乙
究	穴 九
穸	穴 夕
穹	穴 弓
空	穴 工
穻	穴 于
穼	穴 木
穽	穴 井
穾	穴 夭
穿	穴 牙
窀	穴 屯
突	穴 犬
窂	穴 牛
窄	穴 乍
窅	穴 目
窆	穴 乏
窇	穴 包
窈	穴 幼
窉	穴 丙
窊	穴 瓜
窋	穴 出
窌	穴 卯
窏	穴 汙
窐	穴 圭
窒	穴 至
窓	穴 厶 心
窔	穴 交
窕	穴 兆
窖	穴 告
窗	穴 囱
窘	穴 君
窙	穴 孝
窚	穴 成
窛	穴 元 女
窞	穴 臽
窟	穴 屈
窠	穴 果
窡	穴 叕
窢	穴 或
窣	穴 卒
窨	穴 音
窝	穴 呙
洼	氵 圭
窫	穴 契
窬	穴 俞
穷	穴 力
窑	穴 缶
窑	穴 缶
窱	穴 條
窲	穴 料
窳	穴 瓜 瓜
窴	穴 真
窎	穴 鸟
窭	穴 娄
窷	穴 聊
窸	穴 悉
窹	穴 爿 吾
窥	穴 规
窻	窗 心
窼	穴 巢
窾	穴 款
窿	穴 隆
竁	穴 毳
竂	穴 尞
窜	穴 串
窍	穴 巧
竆	穴 躳
窦	穴 卖
灶	火 土
窃	穴 切
立	亠 丷 一
竌	立 几
竎	立 廾
竐	立 殳
竑	立 厷
竒	亠 丷 可
竗	立 少
竘	立 句
站	立 占
竚	立 宁
竛	立 令
龙	尤 丿
竝	立 立
竟	立 日 儿
章	立 早
竢	立 矣
竣	立 夋
竤	立 宏
童	立 里
竦	立 束
竧	立 身
竨	立 卓
竩	立 宜
竖	丨 丨 又 立
竬	立 禹
竭	立 曷
竮	立 屏
端	立 山 而
竰	立 厘
竲	立 曾
竳	立 登
竴	立 尊
竵	立 一 口 匸 丨 冂 丷 丅
竞	立 兄
竸	竝 覞
竹	丿 一 丨 丿 一 亅
竺	竹 二
竻	竹 力
竼	竹 凡
竽	竹 于
竾	竹 也
竿	竹 干
笀	竹 亡
笁	竹 工
笄	竹 开
笅	竹 爻
笆	竹 巴
笇	竹 卞
笈	竹 及
笉	竹 畇
笊	竹 爪
笌	竹 牙
笍	竹 内
笎	竹 元
笏	竹 勿
笐	竹 亢
笑	竹 夭
笒	竹 今
笓	竹 比
笖	竹 以
笗	竹 冬
笘	竹 占
笙	竹 生
笚	竹 甲
笛	竹 由
笜	竹 出
笝	竹 囗 又
笞	竹 台
笟	竹 瓜
笠	竹 立
笡	竹 且
笢	竹 民
笣	竹 包
笤	竹 召
笥	竹 司
符	竹 付
笧	竹 册
笨	竹 本
笩	竹 代
笪	竹 旦
笫	竹 丿 ㇉ 丨 丿
第	竹 弓 丨 丿
笭	竹 令
笮	竹 乍
笯	竹 奴
笰	竹 弗
笱	竹 句
笲	竹 弁
笳	竹 加
笴	竹 可
笵	竹 氾
笶	竹 矢
笷	竹 卯
笸	竹 叵
笻	竹 卭
笿	竹 各
筀	竹 圭
筁	竹 曲
筂	竹 池
筃	竹 因
筄	竹 兆
筅	竹 先
笔	竹 毛
筇	竹 邛
筈	竹 舌
等	竹 寺
筊	竹 交
筋	竹 月 力
筌	竹 全
笋	竹 尹
筎	竹 如
筏	竹 伐
筐	竹 匡
筒	竹 同
筓	竹 幵
答	竹 合
筕	竹 行
策	竹 朿
筗	竹 仲
筘	竹 扣
筙	竹 耒
筞	竹 宋
筟	竹 孚
筠	竹 均
筡	竹 余
筢	竹 把
筣	竹 利
筤	竹 良
筥	竹 呂
筦	竹 完
笕	竹 见
筨	竹 含
筩	竹 甬
筪	竹 匣
筬	竹 成
筭	竹 弄
筮	竹 巫
筯	竹 助
筰	竹 作
筱	竹 攸
筲	竹 肖
筳	竹 廷
筵	竹 延
筶	竹 告
筷	竹 快
筸	竹 旱
筻	竹 更
箁	竹 咅
箃	竹 取
箄	竹 卑
箅	竹 畀
箆	内 比
箇	竹 固
箈	竹 治
箉	竹 拐
箊	竹 於
笺	竹 戋
箌	竹 到
箍	竹 扌 匝
箎	竹 虎
筝	竹 争
箐	竹 青
箑	竹 疌
箒	竹 帚
箔	竹 泊
箕	竹 其
箖	竹 林
算	竹 目 廾
箘	竹 囷
箙	竹 服
箚	竹 合 刂
箛	竹 孤
箜	竹 空
箝	竹 拑
箞	竹 卷
箟	竹 昆
箠	竹 垂
管	竹 官
箢	竹 宛
箣	竹 刺
箤	竹 卒
箥	竹 波
箬	竹 若
箭	竹 前
箯	竹 便
箰	筍 子
箱	竹 相
箲	竹 洗
箳	竹 屏
箴	竹 咸
箵	竹 省
箶	竹 胡
箷	竹 施
箸	竹 者
箺	竹 春
箻	竹 律
箼	竹 屋
箽	竹 重
箾	竹 削
箿	竹 咠
节	竹 卩
篁	竹 皇
篂	竹 星
篃	竹 眉
范	艸 氾
篅	竹 耑
篆	竹 彖
篇	竹 扁
篈	竹 封
筑	竹 巩
篊	竹 洪
箧	竹 匚 夹
篌	竹 侯
篍	竹 秋
篎	竹 眇
篏	竹 甘 欠
筼	竹 员
篕	竹 盍
篖	竹 唐
篗	竹 隻
篘	竹 芻
篙	竹 高
篚	竹 匪
篛	竹 弱
篜	竹 烝
篝	竹 冓
篞	竹 水 日 工
篟	竹 倩
筿	竹 条
篡	竹 目 大 厶
篣	竹 旁
笃	竹 马
篥	竹 栗
篦	竹 囟 比
篧	竹 隺
篨	竹 除
筛	竹 师
篪	竹 虒
篫	竹 巩 手
笼	竹 龙
篰	竹 部
篲	竹 彗
筚	竹 毕
篴	竹 逐
篶	竹 焉
篷	竹 逢
篹	竹 目 大 㔾
篺	竹 捭
篻	竹 票
篼	竹 兜
篽	竹 御
篾	竹 罒 戍
箦	竹 责
簁	竹 徙
簃	竹 移
簄	竹 扈
簅	竹 產
簆	竹 寇
簇	竹 族
簈	竹 幷
簉	竹 造
簊	竹 基
簋	竹 艮 皿
簌	竹 欶
篓	竹 娄
簎	竹 措
簏	竹 鹿
簑	竹 衰
簒	竹 目 大 么
簔	竹 衰
簕	竹 勒
箫	竹 肃
簙	竹 博
簚	竹 罒 戈 巾
簛	竹 斯
簝	竹 尞
箪	竹 単
簟	竹 覃
簠	竹 盙
简	竹 间
篑	竹 贵
簦	竹 登
簧	竹 黄
簨	竹 巽
簮	竹 夫 夫 日
箫	竹 肃
簬	竹 路
簭	竹 筮 人 口
簮	竹 夫 夫 日
簰	竹 牌
簲	竹 脾
簳	竹 幹
簴	竹 虡
簶	竹 祿
檐	木 詹
簸	竹 其 皮
筜	竹 当
簺	竹 塞
簼	竹 搆
签	竹 佥
帘	穴 巾
簿	竹 薄
籀	竹 扌 留
篮	竹 监
籅	竹 與
籆	竹 蒦
籇	竹 豪
籈	竹 甄
籊	竹 翟
筹	竹 寿
籍	竹 耤
籐	竹 滕
籑	竹 目 大 良
籒	竹 扌 畱
籓	竹 潘
䉤	竹 数
籕	竹 榴
籗	竹 霍
籘	竹 縢
箓	竹 录
篯	竹 戋
箨	竹 择
籝	竹 嬴
籞	竹 禦
籁	竹 赖
笼	竹 龙
签	竹 佥
籥	竹 龠
籦	竹 鍾
籧	竹 豦
笾	竹 边
簖	竹 断
篱	竹 离
箩	竹 罗
籯	竹 贏
籰	竹 矍
籱	竹 雨 隹 隹
吁	口 于
米	丷 木
籵	米 十
籶	米 几
籷	米 乇
籸	米 卂
籹	米 女
籺	米 乞
籼	米 山
籽	米 子
籾	米 刃
籿	米 寸
粁	米 千
粃	米 比
粄	米 反
粅	米 勿
粆	米 少
粇	米 亢
粈	米 丑
粉	米 分
粊	比 米
粋	米 卆
粍	米 毛
粎	米 尺
粑	米 巴
粒	米 立
粓	米 甘
粔	米 巨
粕	米 白
粖	米 末
粗	米 且
粘	米 占
粙	米 由
粚	米 丿 一 也
肃	肀 八 丿 丨
粜	出 米
粞	米 西
粟	襾 米
粠	米 共
粡	米 同
粢	次 米
粥	弓 米 弓
粦	米 舛
粨	米 百
粰	米 孚
粱	氵 刀 八 米
粲	歺 又 米
粳	米 更
粴	米 里
粤	丶 冂 米 亏
粶	米 录
粷	米 匊
粸	米 其
粹	米 卒
粺	米 卑
粼	粦 巜
粽	米 宗
精	米 青
粿	米 果
糂	米 甚
糄	米 扁
糅	米 柔
糆	米 面
糇	米 侯
糈	米 胥
粽	米 宗
糊	米 胡
糋	米 前
糌	米 夂 人 日
糍	米 兹
糎	米 厘
糏	米 屑
糐	米 尃
糑	米 弱
糒	米 艹 厂 用
糓	士 冖 一 米 殳
糔	米 蚤
糕	米 羔
糖	米 唐
糗	米 臭
糙	米 造
粧	米 庄
糛	米 堂
糜	麻 米
糁	米 参
粪	米 共
糟	米 曹
糠	米 康
糡	米 竟
糢	米 莫
糣	米 朁
糤	米 散
糥	米 需
糦	米 喜
粮	米 良
糨	米 強
糪	辟 米
糫	米 睘
糯	米 需
团	囗 才
糱	辥 米
粝	米 厉
糳	丵 臼 殳 米
籴	入 米
糵	薛 米
糶	粜 翟
糸	幺 小
系	丿 幺 小
纠	纟 丩
纪	纟 己
纣	纟 寸
约	纟 勺
红	纟 工
纡	纟 于
纥	纟 乞
纨	纟 丸
纫	纟 刃
紊	文 糸
纹	纟 文
纳	纟 内
纽	纟 丑
纾	纟 予
纯	纟 屯
纰	纟 比
纼	纟 引
纱	纟 少
纮	纟 厷
纸	纟 氏
级	纟 及
纷	纟 分
纭	纟 云
纴	纟 壬
素	丰 糸
纺	纟 方
索	十 冖 糸
紥	扎 糸
紫	此 糸
扎	扌 乚
累	田 丝
细	纟 田
绂	纟 犮
绁	纟 世
绅	纟 申
纻	纟 宀 一
绍	纟 召
绀	纟 甘
绋	纟 弗
绐	纟 台
绌	纟 出
终	纟 冬
组	纟 且
绊	纟 半
经	纟 圣
绗	纟 行
结	纟 吉
绝	纟 色
絛	攸 糸
絜	丰 刀 糸
绔	纟 夸
绞	纟 交
络	纟 各
绚	纟 旬
给	纟 合
绒	纟 戎
絫	厽 糸
絭	𠔉 糸
絮	如 糸
绖	纟 至
统	纟 充
丝	纟 纟
绛	纟 夅
绘	纟 会
绝	纟 色
绢	纟 肙
绑	纟 邦
绡	纟 肖
绠	纟 更
绨	纟 弟
绤	纟 谷
绥	纟 妥
经	纟 圣
綔	夸 系
综	纟 宗
缍	纟 垂
绿	纟 录
绸	纟 周
绻	纟 卷
綤	邵 糸
綦	其 糸
线	纟 戋
绶	纟 受
维	纟 隹
綮	户 攵 糸
绹	纟 匋
绾	纟 官
纲	纟 冈
网	冂 乂 乂
绷	纟 朋
缀	纟 叕
采	爫 木
纶	纟 仑
绺	纟 咎
绮	纟 奇
绽	纟 定
绰	纟 卓
绫	纟 夌
绵	纟 帛
绲	纟 昆
缁	纟 甾
紧	丨 丨 又 丝
绯	纟 非
总	丷 口 心
緐	每 系
绿	纟 录
绪	纟 者
绬	纟 英
绱	纟 尚
绪	纟 者
缃	纟 相
缄	纟 咸
缂	纟 革
线	纟 戋
缐	纟 泉
緜	帛 系
缉	纟 咠
缎	纟 段
缔	纟 帝
缗	纟 昬
缘	纟 彖
缌	纟 思
编	纟 扁
缓	纟 爰
缅	纟 面
纬	纟 韦
缑	纟 侯
缈	纟 目 少
緳	广 絜
练	纟 东 一
缏	纟 便
缇	纟 是
致	至 攴
缊	纟 昷
缠	纟 厘
总	丷 口 心
萦	艹 冖 丝
缙	纟 晋
缢	纟 益
缒	纟 追
縏	般 糸
绉	纟 刍
缣	纟 兼
缊	纟 昷
缞	纟 衰
缚	纟 尃
缜	纟 真
缟	纟 高
缛	纟 辱
縠	士 冖 系 殳
縢	月 絭
县	且 厶
纵	纟 从
绦	纟 条
缝	纟 逢
缡	纟 离
缩	纟 宿
纵	纟 从
缧	纟 累
缦	纟 曼
絷	执 糸
缕	纟 娄
缥	纟 票
縻	麻 糸
总	丷 口 心
绩	纟 责
繁	每 攵 糸
绷	纟 朋
繄	殹 糸
缫	纟 巢
缪	纟 翏
繇	月 缶 系
繋	軗 糸
绣	纟 秀
缯	纟 曾
织	纟 只
缮	纟 善
缭	纟 尞
繛	素 卓
绕	纟 尧
繠	惢 糸
绣	纟 秀
缋	纟 贵
繤	苜 大 糸
绳	纟 黾
绘	纟 会
系	丿 幺 小
茧	草 虫
缰	纟 畺
缳	纟 睘
缲	纟 喿
缴	纟 敫
繴	辟 糸
绎	纟 又 二 丨
继	纟 丨 一 米
缤	纟 宾
缱	纟 遣
纂	竹 目 大 糸
颣	米 糸 页
缬	纟 颉
纩	纟 广
续	纟 卖
纍	畾 糸
缠	纟 广 里
缠	纟 广 里
缨	纟 婴
才	一 亅 丿
纤	纟 千
缵	纟 赞
纛	毒 縣
缆	纟 览
缶	丿 二 山
缷	缶 卩
缸	缶 工
缹	缶 灬
缺	缶 夬
缻	缶 瓦
钵	钅 本
缾	缶 并
缿	缶 后
罄	殸 缶
罅	缶 虖
罇	缶 尊
坛	土 云
罉	缶 掌
罋	雍 缶
罂	贝 贝 缶
罍	畾 缶
坛	土 云
罐	缶 雚
罒	冖 丨 丨 一
罓	冖 乂
罔	冂 丷 一 亡
罕	罓 干
罘	罒 不
罙	罒 木
罛	罒 瓜
罜	罒 主
罝	罒 且
罞	罒 矛
罟	罒 古
罠	罒 民
罡	罒 正
罣	罒 圭
罤	罒 弟
罥	罒 肙
罦	罒 孚
罧	罒 林
罨	罒 奄
罩	罒 卓
罪	罒 非
罫	罒 卦
罬	罒 叕
罭	罒 或
置	罒 直
罯	罒 音
罚	罒 讠 刂
罱	罒 南
署	罒 者
罳	罒 思
骂	口 口 马
罶	罒 留
罢	罒 去
罚	罒 讠 刂
罹	罒 忄 隹
罺	罒 巢
罻	罒 尉
罽	罒 厂 剡
罾	罒 曾
罿	罒 童
羀	罒 畱
羃	罒 幕
罗	罒 夕
罴	罢 灬
羇	罒 革 奇
羁	罒 革 马
羊	丷 三 丨
羋	卝 丨 干
羌	羊 儿
羍	大 羊
美	羊 大
羏	羊 彡
羐	艹 土 久
羑	羊 久
羒	羊 分
羓	羊 巴
羔	羊 灬
羕	羊 永
羖	羊 殳
羗	羌 厶
羘	月 羊
羙	羊 火
羚	羊 令
羛	羊 弗
羜	羊 宁
羝	羊 氐
羞	羊 丿 丑
羠	羊 夷
羢	羊 戎
羣	君 羊
群	君 羊
羟	羊 圣
羦	羊 完
羧	羊 夋
羡	羊 次
义	丶 乂
羫	羊 空
羬	羊 咸
羭	羊 俞
羮	羔 一 夫
羯	羊 曷
羰	羊 炭
羱	羊 原
羲	羊 禾 丂 戈
羳	羊 番
羶	羊 亶
羶	羊 亶
羸	亡 口 月 羊 凡
羹	羔 美
羺	羊 需
羼	尸 羴
羽	习 习
羾	羽 工
羿	羽 廾
翀	羽 中
翁	公 羽
翂	羽 分
翃	厷 羽
翄	羽 支
翅	支 羽
翆	羽 卆
翇	羽 犮
翈	甲 羽
翉	本 羽
翊	立 羽
翋	羽 立
翌	羽 立
翍	羽 皮
翎	令 羽
翏	羽 人 彡
翐	羽 失
翑	羽 句
习	刁 丶
翓	吉 羽
翔	羊 羽
翕	合 羽
翖	合 羽
翗	多 羽
翛	攸 羽
翝	宏 羽
翞	羽 京
翟	羽 隹
翠	羽 卒
翡	非 羽
翢	周 羽
翣	羽 妾
翤	口 冊
翥	者 羽
翦	前 羽
翧	宣 羽
翨	羽 是
翩	扁 羽
翪	羽 凶 八 夂
翫	習 元
翚	羽 军
翭	羽 侯
翮	鬲 羽
翯	羽 高
翰	十 日 十 人 羽
翲	票 羽
翳	殹 羽
翷	粦 羽
翘	尧 羽
翱	皋 羽
翻	番 羽
翼	羽 異
翙	岁 羽
翾	睘 羽
耀	光 翟
老	耂 匕
耂	土 丿
考	耂 丂
耄	老 毛
者	耂 日
耆	老 日
耇	耂 句
耈	老 句
耉	考 口
耊	耂 至
耋	老 至
而	一 丶 冂 丨 丨
耍	而 女
耎	而 大
耏	而 彡
耐	而 寸
耑	山 而
耒	一 未
耓	耒 丁
耔	耒 子
耕	耒 井
耖	耒 少
耗	耒 毛
耘	耒 云
耙	耒 巴
耚	耒 皮
耛	耒 台
耜	耒 尸 乛 一
耝	耒 且
耞	耒 加
耟	耒 巨
耠	耒 合
耡	耒 助
耤	耒 昔
耥	耒 尚
耦	耒 禺
耨	耒 辱
耩	耒 冓
耪	耒 旁
耫	耒 責
耧	耒 娄
耢	耒 劳
耯	耒 蒦
耰	耒 憂
耱	耒 磨
耲	耒 褱
耴	耳 乚
耵	耳 丁
耶	耳 阝
耷	大 耳
耹	耳 今
耺	耳 云
耼	耳 冄
耽	耳 冘
耾	耳 厷
耿	耳 火
聀	耳 戈
聃	耳 冉
聄	耳 人 彡
聅	耳 矢
聆	耳 令
聇	耳 正
聈	耳 幼
聉	耳 出
聊	耳 卯
聎	耳 兆
聏	耳 而
聐	耳 吉
聑	耳 耳
聒	耳 舌
聕	耳 告
圣	又 土
聘	耳 由 丂
聙	耳 青
聚	耳 又 乑
聛	耳 卑
聜	耳 空
聝	耳 或
闻	门 耳
聟	知 耳
聠	耳 并
聡	耳 忩
聤	耳 亭
聥	耳 禹
聦	耳 葱
聧	耳 癸
聫	耳 幺 幺 大
聬	耳 翁
聭	耳 鬼
联	耳 关
聪	耳 总
聱	敖 耳
声	士 尸 丨
耸	从 耳
听	口 斤
聩	耳 贵
聂	耳 又 又
职	耳 只
聸	耳 詹
聍	耳 宁
听	口 斤
听	口 斤
聋	龙 耳
聿	彐 二 丨
肀	彐 丨
肁	户 聿
肂	歹 聿
肄	匕 矢 聿
肃	肀 八 丿 丨
肆	镸 聿
肇	户 攴 聿
肈	户 戈 聿
肉	冂 入 入
肊	月 乙
肋	月 力
肌	月 几
肍	月 九
肎	冖 月
肏	入 肉
肐	月 乞
肑	月 勺
肒	月 丸
肓	亡 月
肔	月 也
肕	月 刃
肖	小 月
肗	月 女
肘	月 寸
肙	口 月
肚	月 土
肛	月 工
肜	月 彡
肝	月 干
肞	月 义
肟	月 亏
股	月 殳
肢	月 支
肣	月 今
肥	月 巴
肦	月 分
肧	月 不
肨	月 丰
肩	戶 月
肪	月 方
肫	月 屯
肬	月 尤
肭	月 內
肮	月 亢
肯	止 月
肰	月 犬
肱	月 厷
育	亠 厶 月
肳	月 勿
肵	月 斤
肶	月 比
肷	月 欠
肸	月 八 十
肹	月 兮
肺	月 巿
肻	卜 冖 肉
肼	月 井
肽	月 太
胂	月 申
胃	田 月
胄	由 月
胅	月 失
胇	月 弗
胈	月 犮
胉	月 白
胊	月 句
胋	月 占
背	北 月
胍	月 瓜
胎	月 台
胏	月 丿 ㇉ 丨 丿
胐	月 出
胑	月 只
胒	月 尼
胓	月 平
胔	此 月
胕	月 付
胖	月 半
胗	月 人 彡
胘	月 玄
胙	月 乍
胚	月 丕
胛	月 甲
胝	月 氐
胞	月 包
胟	月 母
胠	月 去
胡	古 月
胢	月 可
胣	月 丿 一 也
胤	丿 幺 月 乚
胥	疋 月
胦	月 央
胩	月 卡
胬	奴 月
胭	月 因
胮	月 夅
胯	月 夸
胰	月 夷
胱	月 光
胲	月 亥
胳	月 各
胴	月 同
胵	月 至
胷	匈 月
胸	月 匈
胹	月 而
胺	月 安
胻	月 行
能	厶 月 匕 匕
胾	土 戈 肉
脀	丞 月
脁	月 兆
脂	月 旨
脃	月 色
脄	月 灰
胁	月 办
脆	月 危
脇	月 劦
脉	月 永
脊	月 人 二 二
脎	月 杀
脒	月 米
脕	月 免
脖	月 孛
脗	月 勿 口
脘	月 完
脙	月 求
胫	月 圣
脜	月 一 自
脝	月 亨
脞	月 坐
脟	月 寽
脠	月 延
脡	月 廷
脢	月 每
脣	辰 月
脤	月 辰
脦	月 忒
脧	月 夋
脨	月 束
脩	攸 月
脪	月 希
脱	月 兑
脬	月 孚
脭	月 呈
脮	月 妥
脯	月 甫
脰	月 豆
脲	月 尿
脴	月 否
脵	月 吴
脷	月 利
胀	月 长
脺	月 卒
脽	月 隹
脾	月 卑
脿	月 表
胼	月 并
腂	月 果
腃	月 卷
腄	月 垂
腅	月 炎
腆	月 典
腇	月 委
腈	月 青
腉	月 兒
腋	月 夜
腍	月 念
肾	丨 丨 又 月
腏	月 叕
腐	广 付 肉
腑	月 府
腒	月 居
腓	月 非
腔	月 空
腕	月 宛
胨	月 东
腗	月 畁
腙	月 宗
腚	月 定
腛	月 屋
腜	月 某
腝	月 耎
腞	月 彖
腟	月 室
腠	月 奏
脶	月 呙
腢	月 禺
腣	月 帝
腤	月 音
腥	月 星
脑	月 亠 乂 凵
腧	月 俞
腨	月 耑
腩	月 南
肿	月 中
腬	月 柔
腭	月 咢
腮	月 思
腯	月 盾
腰	月 要
腱	月 建
腲	月 畏
脚	月 却
腴	月 臾
腵	月 叚
腶	月 段
腷	月 畐
肠	月 弓 丿 丿
腹	月 复
腺	月 泉
腿	月 退
膀	月 旁
膁	月 兼
膂	旅 月
腽	月 昷
膄	月 叟
膅	月 唐
膆	月 素
膇	月 追
膈	月 鬲
膉	月 益
膊	月 尃
膌	月 脊
膍	月 囟 比
膎	月 奚
膏	高 月
膐	旅 月
肠	月 弓 丿 丿
膔	月 鹿
腘	月 国
膖	月 逢
膗	月 崔
膘	月 票
膙	月 強
肤	月 夫
膛	月 堂
膜	月 莫
膝	月 桼
膟	月 率
胶	月 交
膡	月 眷
膣	月 窒
膥	末 成
膦	月 粦
膧	月 童
膨	月 彭
腻	月 贰
膪	月 啻
膫	月 尞
膬	月 毳
膯	月 登
膰	月 番
膲	月 焦
膳	月 善
膵	月 萃
膺	广 人 隹 月
膻	月 亶
胆	月 旦
脍	月 会
脓	月 农
臀	月 殿
臁	月 廉
臂	月 辟
臃	月 雍
臄	月 豦
臅	月 蜀
臆	月 意
臇	月 雋
臈	月 葛
脸	月 佥
臊	月 喿
臋	殿 月
臌	月 鼓
脐	月 齐
臎	月 翠
膑	月 宾
臐	月 熏
臑	月 需
臒	月 蒦
脏	月 庄
臕	月 麃
臖	興 月
腊	月 昔
臙	月 燕
胪	月 卢
臛	月 霍
臝	亡 口 月 果 凡
臞	月 瞿
脏	月 庄
脔	亦 肉
臜	月 赞
臣	巨 丶 丶
臤	臣 又
卧	臣 卜
臧	爿 戊 臣
临	丨 丨 丿 一 丶 口 丨
臩	臦 夰
自	丶 目
臫	自 乚
臬	自 木
臭	自 犬
臮	自 丅 人 人
臯	自 二 十 二
臰	自 死
臱	自 穴 方
臲	臬 危
至	一 厶 土
致	至 攵
臵	至 各
臶	至 存
臷	土 戈 至
臸	至 至
臹	至 成
台	厶 口
臻	至 秦
臼	丿 丨 一 彐
臽	刀 臼
臾	臼 人
臿	干 臼
舀	爫 臼
舁	臼 廾
舂	夫 一 臼
舃	臼 一 勹 灬 舄
舄	臼 勹 灬
舅	臼 男
与	一 ㇉ 一
兴	丷 六
举	兴 二 丨
旧	丨 日
舋	臼 同 冖 且
舌	千 口
舍	人 舌
舏	舌 丩
舐	舌 氏
舑	舌 冉
舒	舍 予
舓	舌 易
舔	舌 忝
舕	舌 炎
铺	钅 甫
铺	钅 钅 甫
舘	人 舌 官
舙	舌 舌 舌
舚	舌 詹
舛	夕 匸 丨
舜	爫 冖 舛
舝	土 巛 冖 牟
舞	丿 一 一 丨 丨 丨 丨 一 舛
舟	丶 冂 一 丶 丨
舠	舟 刀
舡	舟 工
舢	舟 山
舥	舟 巴
舦	舟 太
舧	舟 凡
舨	舟 反
舩	舟 公
航	舟 亢
舫	舟 方
般	舟 殳
舭	舟 比
舯	舟 中
舲	舟 令
舳	舟 由
舴	舟 乍
舵	舟 它
舶	舟 白
舷	舟 玄
舸	舟 可
船	舟 八 口
舺	舟 甲
舼	舟 共
舽	舟 夅
舾	舟 西
艀	舟 孚
艁	舟 告
艂	舟 夆
艃	舟 里
艄	舟 肖
艅	舟 余
艆	舟 良
艇	舟 廷
艉	舟 尾
艊	舟 帛
艋	舟 孟
艌	舟 念
艍	舟 居
艎	舟 皇
艏	舟 首
艐	舟 凶 八 夂
艑	舟 扁
艒	舟 冒
艓	舟 枼
艕	舟 旁
艖	舟 差
艗	舟 益
艘	舟 叟
舱	舟 仓
艚	舟 曹
艞	舟 筄
艟	舟 童
舣	舟 义
艥	舟 咠 戈
舰	舟 见
艧	舟 蒦
艨	舟 蒙
舻	舟 卢
艬	舟 毚
良	丶 艮
艰	又 艮
色	刀 巴
艴	弗 色
艵	并 色
艳	丰 色
艳	丰 色
艸	山 山
艹	一 丨 丨
艻	艸 力
艼	艸 丁
艽	艸 九
艾	艸 乂
艿	艸 乃
芀	艸 刀
芁	艸 几
芃	艸 凡
芄	艸 丸
芅	艸 弋
芆	艸 叉
芇	艸 巾
芈	艸 卝 二 丨
芉	艸 干
芊	艸 千
芋	艸 于
芌	艸 亏
芍	艸 勺
芎	艸 弓
芏	艸 土
芐	艸 下
芑	艸 己
芒	艸 亡
芓	艸 子
芔	屮 艸
芕	艸 夕
芖	艸 大
芘	艸 比
芙	艸 夫
芚	艸 屯
芛	艸 尹
芝	艸 之
芞	艸 气
芟	艸 殳
芠	艸 文
芡	艸 欠
芢	艸 仁
芣	艸 不
芤	艸 孔
芥	艸 介
芧	艸 予
芨	艸 及
芩	艸 今
芪	艸 氏
芫	艸 元
芬	艸 分
芭	艸 巴
芮	艸 內
芯	艸 心
芰	艸 支
花	艸 化
芲	艸 人 七
芳	艸 方
芴	艸 勿
芵	艸 夬
芶	艸 勾
芷	艸 止
芸	艸 云
芹	艸 斤
芺	艸 夭
刍	刀 彐
芼	艸 毛
芽	艸 牙
芾	艸 巿
芿	艸 仍
苀	艸 亢
苂	艸 火
苃	艸 友
苄	艸 卞
苅	艸 刈
苉	艸 匹
苊	艸 厄
苐	艸 弔
苑	艸 夗
苒	艸 冉
苓	艸 令
苔	艸 台
苕	艸 召
苖	艸 由
苗	艸 田
苘	艸 冋
苙	艸 立
苚	艸 用
苛	艸 可
苜	艸 目
苝	艸 北
苞	艸 包
苟	艸 句
苠	艸 民
苡	艸 以
苢	艸 尸 乛 一
苣	艸 巨
苤	艸 丕
若	艸 右
苦	艸 古
苎	艸 宀 一
苨	艸 尼
苩	艸 白
苪	艸 丙
苫	艸 占
苬	艸 囚
苭	艸 幼
苮	艸 仙
苯	艸 本
苰	艸 弘
英	艸 央
苲	艸 乍
苳	艸 冬
苴	艸 且
苵	艸 失
苶	艸 尒
苷	艸 甘
苸	艸 乎
苺	艸 母
苻	艸 付
苼	艸 生
苽	艸 瓜
苾	艸 必
苿	艸 未
茀	艸 弗
茁	艸 出
茂	艸 戊
范	艸 氾
茄	艸 加
茅	艸 矛
茆	艸 卯
茇	艸 犮
茈	艸 此
茉	艸 末
茊	艸 丘
茋	艸 氐
茌	艸 仕
茍	艸 句
茓	艸 穴
茖	艸 各
茗	艸 名
茘	艸 刕
茙	艸 戎
茚	艸 印
茛	艸 艮
茜	艸 西
茝	艸 臣
茞	艸 臣
茟	艸 聿
茠	艸 休
茡	艸 字
茢	艸 列
茤	艸 多
茥	艸 圭
茦	艸 朿
茨	艸 次
茩	艸 后
茪	艸 光
茫	艸 氵 亡
茬	艸 在
茭	艸 交
茮	艸 尗
茯	艸 伏
茰	艸 由 乂
茱	艸 朱
兹	丷 一 幺 幺
茳	艸 江
茴	艸 回
茵	艸 因
茶	艸 人 一 小
茷	艸 伐
茸	艸 耳
茹	艸 如
茺	艸 充
茻	艸 艸
茼	艸 同
茽	艸 仲
茿	艸 巩
荀	艸 旬
荁	艸 亘
荂	艸 夸
荃	艸 全
荄	艸 亥
荅	艸 合
荇	艸 行
荈	艸 舛
草	艸 早
荆	井 刂
荋	艸 而
荌	艸 安
荍	艸 收
荎	艸 至
荏	艸 任
荑	艸 夷
荒	艸 巟
荓	艸 并
荔	艸 劦
荕	艸 肋
荖	艸 老
荗	艸 戍
庄	广 土
荰	艸 杜
荱	艸 尾
荲	艸 里
荳	艸 豆
荴	艸 扶
荵	艸 忍
荶	艸 吟
荷	艸 何
荸	艸 孛
荹	艸 步
荺	艸 均
荻	艸 狄
荼	艸 余
荽	艸 妥
荾	艸 夋
荿	艸 成
莀	艸 辰
莁	艸 巫
莂	艸 別
莃	艸 希
莄	艸 更
莆	艸 甫
莇	艸 助
莈	艸 沒
莉	艸 利
庄	广 土
莋	艸 作
莌	
莍	艸 求
莎	艸 沙
莏	艸 抄
莐	艸 沈
莑	艸 夆
莒	艸 吕
莓	艸 每
莔	艸 囧
莕	艸 杏
茎	艸 圣
莘	艸 辛
莙	艸 君
莚	艸 延
莛	艸 廷
莜	艸 攸
莝	艸 坐
莞	艸 完
莟	艸 今
莠	艸 秀
莡	艸 足
荚	艸 夹
莣	艸 忘
莤	艸 酉
莥	艸 狃
莦	艸 肖
苋	艸 见
莨	艸 良
莩	艸 孚
莪	艸 我
莫	艸 日 大
莬	艸 免
莭	艸 即
莮	艸 男
莯	艸 沐
莰	艸 坎
莽	艸 大 廾
莾	艸 奔
莿	艸 刺
菀	艸 宛
菁	艸 青
菂	艸 的
菃	艸 洰
菅	艸 官
菆	艸 取
菇	艸 姑
菈	艸 拉
菉	艸 彔
菊	艸 匊
菋	艸 味
菌	艸 囷
菍	艸 念
菎	艸 昆
菏	艸 河
菐	业 丷 三 人
菑	艸 甾
菒	艸 杲
果	日 木
菔	艸 服
菖	艸 昌
菗	艸 抽
菘	艸 松
菙	艸 垂
菜	艸 采
菝	艸 犮
菞	艸 禾 勹 丿
菟	艸 兔
菠	艸 波
菡	艸 函
菢	艸 抱
菤	艸 卷
菥	艸 析
菦	艸 近
菧	艸 底
菨	艸 妾
菩	艸 咅
菪	艸 宕
菫	艸 丅 口 三
菬	艸 沼
菭	艸 治
菮	艸 庚
华	化 十
菰	艸 孤
菱	艸 夌
菲	艸 非
菳	艸 金
菴	艸 奄
菵	艸 罔
菶	艸 奉
菷	艸 帚
烟	火 因
菹	艸 沮
菺	艸 肩
菻	艸 林
菼	艸 炎
菽	艸 叔
菾	艸 忝
菿	艸 到
萀	艸 虎
萁	艸 其
萂	艸 和
萃	艸 卒
萄	艸 匋
萅	艸 旾
萆	艸 卑
苌	艸 长
萉	艸 肥
莱	艸 来
萋	艸 妻
萌	艸 明
萍	艸 氵 平
萎	艸 委
萏	艸 臽
萐	艸 疌
萒	艸 兖
萓	艸 宜
萔	艸 招
荠	艸 齐
萖	艸 兒
萗	艸 宗
萘	艸 奈
萛	艸 目 廾
萜	艸 帖
萠	艸 朋
萩	艸 秋
萪	艸 科
萫	艸 香
万	一 刀
萭	艸 禹
萮	艸 俞
萰	艸 柬
萱	艸 宣
萲	艸 爰
萳	艸 南
荝	艸 则
莴	艸 呙
萶	艸 春
萷	艸 削
萸	艸 臾
萹	艸 扁
萺	艸 冒
萻	艸 音
萼	艸 咢
落	艸 洛
萾	艸 盈
萿	艸 活
葀	艸 括
葁	艸 姜
葂	艸 勉
葃	艸 昨
葄	艸 胙
葅	艸 俎
葆	艸 保
葇	艸 柔
葈	艸 枲
叶	口 十
葊	艸 弇
葋	艸 朐
葌	艸 姦
葍	艸 畐
葎	艸 律
葏	艸 津
葐	艸 盆
葑	艸 封
荭	艸 红
葓	艸 洪
葔	艸 侯
葕	艸 衍
葖	艸 突
着	羊 丿 目
著	艸 者
葘	艸 甾 一
葙	艸 相
葚	艸 甚
葛	艸 曷
葜	艸 契
葞	艸 弭
葟	艸 皇
葠	艸 侵
葡	艸 匍
葢	艸 盇
董	艸 重
荮	艸 纣
葥	艸 前
苇	艸 韦
葧	艸 勃
葨	艸 畏
葩	艸 皅
葪	艸 角 刂
葫	艸 胡
葬	艸 死 廾
葭	艸 叚
葮	艸 段
药	艸 约
葰	艸 俊
葲	艸 泉
葳	艸 威
葴	艸 咸
葵	艸 癸
葶	艸 亭
荤	艸 军
葸	艸 思
葹	艸 施
葺	艸 咠
葼	艸 凶 八 夂
葽	艸 要
葾	艸 怨
葿	艸 眉
蒁	艸 述
蒂	艸 帝
蒃	艸 彖
蒄	艸 冠
蒆	艸 巩 女
蒈	艸 皆
蒎	艸 派
蒐	艸 鬼
蒑	艸 殷
莼	艸 纯
莳	艸 时
蒀	艸 昷
蒖	艸 真
蒗	艸 浪
蒘	艸 挐
蒙	艸 冡
蒚	艸 鬲
蒛	艸 缺
蒜	艸 示 示
蒝	艸 原
莅	艸 位
蒟	艸 立 句
蒠	艸 息
蒡	艸 旁
蒢	艸 除
蒣	艸 徐
蒤	艸 涂
蒥	艸 留
蒦	草 隹 又
蒧	艸 戊 占
蒨	艸 倩
蒩	艸 租
蒪	艸 尃
蒫	艸 差
蒬	艸 冤
蒭	艸 芻
蒮	艸 隺
蒯	萠 刂
蒰	艸 般
蒱	艸 捕
蒲	艸 浦
蒴	艸 朔
蒵	艸 奚
蒸	艸 烝
蒹	艸 兼
蒺	艸 疾
蒻	艸 弱
苍	艸 仓
蒽	艸 恩
蒾	艸 迷
蒿	艸 高
荪	艸 孙
蓁	艸 秦
蓂	艸 冥
蓃	艸 叟
蓄	艸 畜
蓅	艸 流
蓆	艸 席
蓇	艸 骨
蓈	艸 郎
蓉	艸 容
蓊	艸 翁
盖	艸 羊 皿
蓌	艸 夎
蓍	艸 耆
蓎	艸 唐
蓏	艸 瓜 瓜
蓐	艸 辱
蓑	艸 衰
蓓	艸 倍
蓔	艸 羔
蓕	艸 桂
蓖	艸 囟 比
蓗	艸 徒
蓚	艸 修
蓛	艸 敇
蓡	艸 浸
蓢	艸 朗
蓧	艸 條
蓨	艸 攸 月
蓪	艸 通
蓫	艸 逐
蓬	艸 逢
蓭	艸 庵
莲	艸 连
苁	艸 从
蓰	艸 徙
蓱	艸 洴
蓳	艸 堇
蓵	艸 捷
蓶	艸 唯
蓷	艸 推
蓸	艸 曹
蓹	艸 御
蓼	艸 翏
荜	艸 毕
蓿	艸 宿
蔀	艸 部
蔁	艸 章
蔂	艸 累
蔃	艸 强
蔆	艸 淩
蔇	艸 既
蔈	艸 票
蓘	艸 衮
蔊	艸 焊
蔋	艸 淑
蔌	艸 欶
蔍	艸 鹿
蔏	艸 商
蔐	艸 啇
蔑	艸 罓 戍
蔒	艸 焄
蔓	艸 曼
卜	丨 丶
蔖	艸 虘
蔗	艸 庶
蔙	艸 旋
蔚	艸 尉
蔛	艸 斛
蔜	艸 敖
蔝	艸 眯
蒌	艸 娄
蔟	艸 族
蔠	艸 終
蔡	艸 祭
蔢	艸 婆
蒋	艸 将
蔤	艸 密
葱	艸 怱
茑	艸 鸟
蔧	艸 彗
蔨	艸 圈
蔩	艸 寅
蔫	艸 焉
蔬	艸 疏
荫	艸 阴
蔰	艸 扈
蔲	艸 寇
蔳	艸 清
麻	广 林
蔵	艸 戉 臣
蔸	艸 兜
蔻	艸 寇
蔽	艸 敝
蔾	菞 木
蕀	艸 棘
荨	艸 寻
蕂	艸 勝
蕃	艸 番
蕅	艸 湡
蒇	艸 戊 贝
蕈	艸 覃
蕉	艸 焦
蕊	艸 惢
蕋	艸 歮
蕌	艸 畾
蕍	艸 渝
荞	艸 乔
蕐	艸 二 人 人 人 人 十
荬	艸 买
芸	艸 云
蕔	艸 報
莸	艸 犹
蕖	艸 渠
蕗	艸 路
荛	艸 尧
蕙	艸 惠
蕚	艸 品 亏
蕛	艸 稊
蕜	艸 悲
蕞	艸 最
蕠	艸 絮
蒉	艸 贵
蕣	艸 舜
蕤	艸 豕 生
蕥	艸 雅
蕨	艸 厥
荡	艸 汤
芜	艸 无
蕫	艸 童
萧	艹 肃
蕮	艸 舄
蕯	艸 隆
蕵	艸 飧
蕶	艸 零
蓣	艸 预
蕸	艸 遐
蕹	艸 雍
蕺	艸 戢
蕻	艸 镸 共
蕼	艸 肆
蕾	艸 雷
蕿	艸 煖
蕰	艸 温
薂	艸 敫
薃	艸 滈
薄	艸 氵 尃
薅	艸 媷
薇	艸 微
荟	艸 会
薉	艸 歲
蓟	艸 鱼 刂
芗	艸 乡
薎	艸 卝
薏	艸 意
薐	艸 稜
姜	羊 女
薒	艸 粲
薓	艸 氵 帚 又
蔷	艸 啬
薕	艸 廉
荙	艸 达
薙	艸 雉
薛	艸 户 乛 一 辛
薜	艸 辟
薝	艸 詹
薞	艸 飱
莶	艸 佥
薡	艸 鼎
薢	艸 解
薣	艸 鼓
薤	艸 歹 韭
薥	艸 蜀
荐	艸 存
薧	艸 亠 口 冂 死
薨	艸 罒 冖 死
萨	艸 阜 产
薪	艸 新
薰	艸 熏
药	艸 约
薯	艸 署
薰	艸 熏
䓕	艸 远
薶	艸 貍
薷	艸 需
薸	艸 漂
薹	艸 臺
荠	艸 齐
薻	艸 漅
薼	艸 塵
薽	艸 甄
薾	艸 爾
薿	艸 疑
藁	艸 槀
藂	艸 聚
藃	艸 歊
藄	艸 綦
藆	艸 搴
藈	艸 睽
借	亻 昔
藊	艸 稨
藋	艸 翟
藌	艸 蜜
蓝	艸 监
荩	艸 尽
藏	艸 臧
藐	艸 貌
藑	艸 夐
藒	艸 禾 曷
藕	艸 耦
藗	艸 遬
藙	艸 毅
藜	艸 黎
艺	艸 乙
藞	艸 磊
藟	艸 畾
藠	艸 皛
藡	艸 適
藢	艸 徵
藤	艸 滕
药	艸 约
藦	艸 摩
藨	艸 麃
藩	艸 潘
薮	艸 数
藫	氵 蕈
藭	艸 窮
藮	艸 樵
藯	艸 慰
藱	艸 廆
藳	艸 稾
蕴	艸 缊
苈	艸 历
蕏	艸 猪
蔼	艸 谒
蔺	艸 门 隹
藻	艸 澡
藼	艸 憲
藽	艸 親
藿	艸 霍
萚	艸 择
蘁	艸 噩
蘂	艸 橤
蘃	艸 歮 木
蕲	艸 单 斤
蘅	艸 衡
芦	艸 户
苏	艸 办
蘉	艸 罒 冖 侵
蕴	艸 缊
苹	艸 平
蘌	艸 禦
薫	艸 熏
蘎	艸 雨 肥
蘑	艸 磨
蘖	艸 檗
蘗	艸 檗
蘘	艸 襄
蘙	艸 翳
藓	艸 鲜
蘛	艸 甚 育
蘜	艸 鞠
蔹	艸 敛
蘡	艸 真 真 女
茏	艸 龙
蘣	
蘥	艸 龠
蘦	艸 霝
蘧	艸 豦
蘨	艸 爫 缶 系
蘩	艸 繁
蘪	艸 麋
兰	丷 三
蘮	艸 罽
蘯	艸 盪
蘲	艸 壘
蘳	
蘴	艸 豊
蘶	艸 魏
蘷	艸 夒
蘸	艸 酉 隹 灬
蘹	艸 懷
蓠	艸 离
蘼	艸 靡
蘽	艸 櫐
蘾	艸 壞
萝	艸 罗
虀	艸 韲
虁	艸 卝 夒
虂	艸 露
虆	艸 纍
虇	艸 弓 雚
虋	艸 釁
虌	艸 鼈
虍	丨 一 厂 七
虎	虍 儿
虐	虍 匸 一
虒	厂 虎
虓	九 虎
虔	虍 文
处	夂 卜
虖	虍 乎
虗	虍 丘
虘	虍 且
虙	虍 必
虚	虍 业
虏	虍 力
虝	虎 勿
虞	虍 吴
号	口 丂
虠	交 虎
虡	虍 丱 一 八
虢	寽 虎
虣	武 虎
虤	虎 虎
亏	一 丂
虨	虍 彬
虩	小 日 小 虎
虪	虎 儵
虭	虫 刀
虬	虫 乚
虰	虫 丁
虱	乁 一 虫
虳	虫 勺
虴	虫 乇
虵	虫 衆
虶	虫 于
虷	虫 干
虸	虫 子
虹	虫 工
虺	兀 虫
虻	虫 亡
虼	虫 乞
蚄	虫 方
蚅	虫 厄
蚆	虫 巴
蚇	虫 尺
蚈	虫 开
蚉	文 虫
蚊	虫 文
蚋	虫 内
蚌	虫 丰
蚍	虫 比
蚎	虫 日
蚏	虫 月
蚐	虫 勻
蚑	虫 支
蚒	虫 丹
蚓	虫 引
蚔	虫 氏
蚖	虫 元
蚗	虫 夬
蚘	虫 尤
蚙	虫 今
蚚	虫 斤
蚛	虫 中
蚜	虫 牙
蚝	虫 毛
蚞	虫 木
蚟	虫 王
蚠	分 虫
蚡	虫 分
蚢	虫 亢
蚣	虫 公
蚤	叉 丶 虫
蚥	虫 父
蚦	虫 冄
蚧	虫 介
蚨	虫 夫
蚩	
蚪	虫 斗
蚫	虫 包
蚭	虫 尼
蚮	虫 代
蚯	虫 丘
蚰	虫 由
蚱	虫 乍
蚲	虫 平
蚳	虫 氐
蚴	虫 幼
蚵	虫 可
蚶	虫 甘
蚷	虫 巨
蚸	虫 斥
蚹	虫 付
蚺	虫 冉
蚻	札 虫
蚼	虫 句
蚽	虫 丕
蚾	虫 皮
蚿	虫 玄
蛀	虫 主
蛁	虫 召
蛂	虫 犮
蛃	虫 丙
蛄	虫 古
蛅	虫 占
蛆	虫 且
蛇	虫 它
蛈	虫 失
蛉	虫 令
蛋	疋 虫
蛌	虫 瓜
萤	艸 冖 虫
蛐	虫 曲
蛑	虫 牟
蛒	虫 各
蛓	
蛔	虫 回
蛕	虫 有
蛖	虫 尨
蛗	户 乛 一 虫
蛘	虫 羊
蛙	虫 圭
蛚	虫 列
蛛	虫 朱
蛜	虫 伊
蛝	虫 艮
蛞	虫 舌
蛟	虫 交
蛠	虫 劦
蛡	虫 羽
蛢	虫 并
蛣	虫 吉
蛤	虫 合
蛥	虫 多
蛦	虫 夷
蛨	虫 百
蛩	巩 虫
蛪	丰 刀 虫
蛫	虫 危
蛬	共 虫
蛭	虫 至
蛶	虫 寽
蛷	虫 求
蛸	虫 肖
蛹	虫 甬
蛱	虫 夹
蜕	虫 兑
蛾	虫 我
蛿	虫 含
蜀	罒 勹 虫
蜁	虫 丿 一 疋
蜂	虫 夆
蜃	辰 虫
蜄	虫 辰
蜅	虫 甫
蚬	虫 见
蜇	折 虫
蜈	虫 吴
蜉	虫 孚
蜊	虫 利
蜋	虫 良
蜌	虫 比 土
蜍	虫 余
蜎	虫 肙
蜏	虫 秀
蜑	延 虫
蜒	虫 延
蜓	虫 廷
蜔	虫 甸
蛔	虫 回
蜘	虫 知
蜙	虫 松
蜚	虫 非
蜛	虫 居
蜜	宓 虫
蜝	其 虫
蜞	虫 其
蜟	虫 育
蜠	虫 囷
蜢	虫 孟
蜣	虫 羌
蜤	析 虫
蜥	虫 析
蜧	虫 戾
蜨	虫 疌
蜩	虫 周
蜪	虫 匋
蜫	虫 昆
蜬	虫 函
蜭	虫 臽
蜮	虫 或
蜯	虫 奉
蜰	肥 虫
蜱	虫 卑
蜲	虫 委
蜳	虫 享
蜴	虫 易
蜶	虫 卒
蜷	虫 卷
蜹	虫 芮
蜺	虫 兒
蜻	虫 青
蜼	虫 隹
蜾	虫 果
蜿	虫 宛
蝂	虫 版
蝃	虫 叕
蛧	虫 网
蝅	天 天 虫
蝆	虫 芈
蜡	虫 昔
蝌	虫 科
蝍	虫 即
蝎	虫 曷
蝏	虫 亭
蝐	虫 冒
蝑	虫 胥
蝒	虫 面
蝓	虫 俞
蝔	虫 皆
蚀	饣 虫
蝖	虫 宣
蝗	虫 皇
蝘	虫 匽
蝙	虫 扁
蝚	虫 柔
蝛	虫 威
蝝	虫 彖
蝞	虫 眉
猬	犭 胃
蝠	虫 畐
蝡	虫 耎
蝣	虫 斿
蝤	虫 酋
蝥	敄 虫
虾	虫 下
蝧	虫 英
虱	乁 一 虫
蝩	虫 重
蝫	虫 者
蝬	
蝭	虫 是
蝮	虫 复
蝯	虫 爰
蝰	虫 奎
蝱	亡 虫 虫
蝲	虫 剌
蝳	虫 毒
蝴	虫 胡
蝵	秋 虫
蝶	虫 枼
蝷	虫 广 屰
蜗	虫 呙
蝹	虫 昷
蝺	虫 禹
蝻	虫 南
蝽	虫 春
蝇	虫 黾
螂	虫 郎
螃	虫 旁
蛳	虫 师
螅	虫 息
螆	虫 兹
螇	虫 奚
螈	虫 原
螉	虫 翁
螊	虫 兼
螋	虫 叟
螌	般 虫
融	鬲 虫
螎	虫 鬲
螏	虫 疾
螑	虫 臭
螒	十 日 十 人 虫
螓	虫 秦
螔	虫 虒
螕	虫 囟 比
螖	虫 骨
螗	虫 唐
螙	木 虫 虫
螚	能 虫
螛	虫 害
螜	士 冖 殳 虫
螝	虫 鬼
蚂	虫 马
螟	虫 冥
螠	虫 益
螡	文 虫 虫
萤	艹 冖 虫
螣	𠔉 虫
螤	蚉 臾
螪	虫 商
螫	赦 虫
螬	虫 曹
螭	虫 离
螯	敖 虫
螰	虫 鹿
螱	尉 虫
螲	虫 窒
螳	虫 堂
螵	虫 票
螶	巨 虫 虫
螷	庳 虫
螸	欲 虫
螺	虫 累
蝼	虫 娄
螼	虫 堇
螽	冬 虫 虫
螾	虫 寅
螀	将 虫
蟀	虫 率
蟁	民 虫 虫
蟃	虫 曼
蛰	执 虫
蟅	虫 庶
蟆	虫 莫
蟇	莫 虫
蝈	虫 国
蟉	虫 翏
蟊	矛 虫 虫
蟋	虫 悉
蟌	虫 悤
蟍	虫 梨
螨	虫 艸 两
蟑	虫 章
蟒	虫 莽
蟓	虫 象
蟔	虫 黑
蟕	虫 觜
蟖	虫 斯
蟗	一 口 丨 冂 出 虫
蟘	虫 貸
蟚	彭 虫
蟛	虫 彭
蟝	虫 渠
蟞	敝 虫
蟟	虫 尞
蟠	虫 番
蟢	虫 喜
虮	虫 几
蟤	虫 巽
蟥	虫 黄
蟨	厥 虫
蟩	虫 厥
蟪	虫 惠
蟫	虫 覃
蝉	虫 单
蟭	虫 焦
蟮	虫 善
蛲	虫 尧
虫	口 厶
蟴	斯 虫
蛏	虫 圣
蟸	豕 虫 虫
蟹	解 虫
蟺	虫 亶
蚁	虫 义
蟼	敬 虫
蟾	虫 詹
蚃	乡 虫
蠂	虫 葉
蠃	亡 口 月 虫 凡
蠄	虫 禽
蝇	虫 黾
虿	万 虫
蠉	虫 睘
蠊	虫 廉
蠋	虫 蜀
蠍	虫 歇
蠎	虫 莾
蠏	虫 解
蛴	虫 齐
蝾	虫 荣
蠓	虫 蒙
蚝	虫 毛
蠕	虫 需
蠖	虫 蒦
蠗	虫 翟
蠘	虫 截
蠚	若 虫 虫
蠛	虫 蔑
蠜	
蠝	虫 畾
蜡	虫 昔
蠠	面 虫 虫
蠡	彖 虫 虫
蠢	春 虫 虫
蛎	虫 厉
蠤	酋 虫 虫
蠥	辥 虫
蠧	士 冖 石 虫 虫
蟏	虫 萧
蠫	
蠭	逢 虫 虫
蠮	虫 翳
蠯	广 卑 虫 虫
蠰	虫 襄
蛊	虫 皿
蠲	益 蜀
蠵	虫 巂
蚕	天 虫
蠷	虫 瞿
蠸	虫 雚
蠹	一 中 冖 石 虫 虫
蚕	天 虫
蛮	亦 虫
蠼	虫 瞿 又
蠽	雀 戈 虫 虫
蠾	虫 屬
蠿	幺 幺 一 丨 一 幺 幺 虫 虫
血	丿 皿
衁	亡 血
衂	血 刄
衃	血 不
衄	血 丑
众	人 人 人
衇	血 𠂢
衈	血 耳
衉	血 各
蔑	艸 罓 戍
衋	聿 百 百 血
行	彳 亍
衍	行 氵
衎	行 干
衏	行 元
衑	行 令
衒	行 玄
术	木 丶
同	冂 一 口
衖	行 共
街	行 土 土
衘	行 午 止
衙	行 吾
胡	古 月
卫	卩 一
衜	行 首
冲	冰 中
卫	卩 一
衟	行 巛 首
衠	行 真
衡	行 刀 田 大
衢	行 瞿
衣	丶 一 
衤	丶 乙 丨 丶 丶
衦	衤 干
衧	衤 于
表	丰 
衩	衤 叉
衪	衤 也
衫	衤 彡
衭	衤 夫
衯	衤 分
衰	衣 中 一
衲	衤 内
衳	衤 公
衴	衤 冘
衵	衤 日
衶	衤 中
衷	一 中 衣
衸	衤 介
衹	衤 氏
衺	衣 牙
衻	衤 冄
衼	衤 支
衽	衤 壬
衾	今 衣
衿	衤 今
袀	衤 勻
袁	土 口 衣
袂	衤 夬
袃	切 衣
袇	衤 丹
袈	加 衣
袉	衤 它
袊	衤 令
袋	代 衣
袌	衣 包
袍	衤 包
袎	衤 幼
袏	衤 左
袐	衤 必
袑	衤 召
袒	衤 旦
袓	衤 且
袔	衤 可
袕	衤 穴
袖	衤 由
袗	衤 人 彡
袘	衤 丿 一 也
袙	衤 白
袚	衤 犮
袛	衤 氐
袝	衤 付
衮	衣 公
袟	衤 失
袠	衣 失
袡	衤 冉
袢	衤 半
袣	衤 世
袤	衣 矛
袦	衤 出
袧	衤 句
袨	衤 玄
袩	衤 占
袪	衤 去
被	衤 皮
袬	衣 台
袱	衤 伏
袲	衣 多
袳	衤 多
袴	衤 夸
袵	衤 任
袶	衤 夅
袷	衤 合
袸	衤 存
袹	衤 百
袺	衤 吉
袻	衤 而
袼	衤 各
袽	衤 如
袾	衤 朱
袿	衤 圭
裀	衤 因
裁	土 戈 衣
裂	列 衣
裉	衤 艮
袅	勹 丶 丨 ㇆ 衣
裋	衤 豆
裍	衤 困
裎	衤 呈
里	田 土
裐	衤 肙
裑	衤 身
裒	衣 臼
裓	衤 戒
裔	衣 冏
裕	衤 谷
裖	衤 辰
裗	衤 亠 厶 川
裘	衣 求
裙	衤 君
裚	折 衣
裛	衣 邑
补	衤 卜
装	壮 衣
裞	
裟	沙 衣
裠	君 衣
里	田 土
裦	衣 厂 二 矛
裧	衤 炎
裨	衤 卑
裩	衤 昆
裪	衤 匋
裬	衤 夌
裭	衤 虎
裮	衤 昌
裯	衤 周
裰	衤 叕
裱	衤 表
裳	尚 衣
裴	非 衣
裵	衣 非
裶	衤 非
裷	衤 卷
裸	衤 果
裹	衣 果
裺	衤 奄
裻	叔 衣
裼	衤 易
制	丿 二 巾 刂
裾	衤 居
裿	衤 奇
褀	衤 其
褁	果 
褂	衤 卦
褃	衤 肯
褅	衤 帝
褆	衤 是
复	丿 一 日 夂
褈	衤 重
褉	衤 契
褊	衤 扁
褋	衤 枼
裈	衤 军
褍	衤 耑
褎	衣 厂 二 禾
褏	衣 厂 二 由
褐	衤 曷
褑	衤 爰
褒	亠 保 衣
褓	衤 保
褔	衤 畐
褕	衤 俞
褖	衤 彖
褗	衤 匽
袆	衤 韦
褙	衤 背
褚	衤 者
褞	衤 昷
褟	衤 日 羽
褠	衤 冓
褡	衤 荅
褢	衣 鬼
褣	衤 容
褤	衤 袁
褥	衤 辱
褦	衤 能
褧	耿 衣
褨	衤 差
褩	般 衣
褪	衤 退
褫	衤 虒
褬	衤 桑
褯	衤 席
褰	宀 井 大 衣
褱	衣 网 二 丨 二
裤	衤 库
裢	衤 连
褵	衤 离
褶	衤 習
褷	衤 徙
褛	衤 娄
亵	执 衣
褼	衤 西 大 己
褽	尉 衣
褾	衤 票
褿	衤 曹
襃	衣 厂 二 呆
襄	口 口 井 一 衣
襆	衤 菐
裥	衤 间
襈	衤 巽
襊	衤 最
襋	衤 棘
襍	衤 集
襎	衤 番
袯	衤 发
襐	衤 象
襒	衤 敝
袄	衤 夭
襙	衤 喿
襚	衤 遂
襜	衤 詹
裣	衤 佥
襞	辟 衣
襟	衤 禁
裆	衤 当
襡	衤 蜀
襢	衤 亶
襣	衤 鼻
褴	衤 监
襥	衤 僕
襦	衤 需
袜	衤 末
襫	衤 奭
摆	扌 罢
襮	衤 暴
衬	衤 寸
袭	龙 衣
襳	衤 韱
襕	衤 阑
襶	衤 戴
襻	衤 攀
襾	一 凵 冂
西	一 囗 儿
覀	一 丨 丨 口
要	襾 女
覂	覀 乏
覃	襾 早
覅	要 勿
覆	覀 復
霸	雨 革 月
覈	襾 敫
覉	覀 革 奇
羁	罒 革 马
见	冂 丿 乚
观	又 见
觃	见 子
规	夫 见
觅	爫 见
视	礻 见
觇	占 见
觉	小 冖 见
觋	巫 见
觍	典 见
觎	俞 见
览	丨 丨 丿 一 丶 罒 见
亲	立 木
觊	岂 见
觏	冓 见
觐	堇 见
观	又 见
覴	登 見
觑	虚 见
觉	小 冖 见
览	丨 丨 丿 一 丶 见
觌	卖 见
观	又 见
觓	角 丩
筋	竹 肉 力
觕	牜 角
觖	角 夬
觗	角 氏
觘	角 少
觙	角 及
觚	角 瓜
觛	角 旦
觜	此 角
觝	角 氐
觟	角 圭
觠	𠔉 角
觡	角 各
觢	丰 刀 角
解	角 刀 牛
觤	角 危
觥	角 光
觧	角 羊
觨	角 汞
觩	角 求
觪	角 辛
觫	角 束
觬	角 兒
觭	角 奇
觮	角 录
觰	角 者
觱	咸 角
觲	角 羊 牛
觳	士 冖 角 殳
觞	角 丿 一 弓 丿 丿
觵	角 黄
觯	角 单
触	角 虫
觺	疑 角
觼	角 夐
觾	角 燕
言	丶 一 二 口
讠	丶 一 二 口 訁
订	讠 丁
讣	讠 卜
訇	勹 言
计	讠 十
讯	讠 卂
讧	讠 工
讨	讠 寸
讦	讠 干
讱	讠 刃
训	讠 川
訔	山 言
讪	讠 山
讫	讠 乞
托	扌 乇
讬	讠 乇
记	讠 己
讹	讠 化
讶	讠 牙
讼	讠 公
诀	讠 夬
讷	讠 內
讻	讠 凶
访	讠 方
设	讠 殳
许	讠 午
译	讠 又 二 丨
诉	讠 斥
诃	讠 可
诊	讠 人 彡
注	氵 主
訾	此 言
诂	讠 古
诋	讠 氐
詈	罒 言
讵	讠 巨
诈	讠 乍
诒	讠 台
诏	讠 召
评	讠 平
诐	讠 皮
诇	讠 冋
诎	讠 出
诅	讠 且
词	讠 司
咏	口 永
诩	讠 羽
询	讠 旬
诣	讠 旨
试	讠 式
詧	夗 言
诗	讠 寺
诧	讠 宅
诟	讠 后
诡	讠 危
诠	讠 全
诘	讠 吉
话	讠 舌
该	讠 亥
详	讠 羊
诜	讠 先
詹	刀 厂 儿 言
诙	讠 灰
诖	讠 圭
诔	讠 耒
诛	讠 朱
诓	讠 匡
夸	大 亏
志	士 心
认	讠 人
诳	讠 狂
诶	讠 矣
誓	折 言
诞	讠 延
誖	訁 孛
诱	讠 秀
诮	讠 肖
语	讠 吾
诚	讠 成
诫	讠 戒
诬	讠 巫
误	讠 吴
诰	讠 告
诵	讠 甬
诲	讠 每
说	讠 兑
说	讠 兑
读	讠 卖
誯	訁 昌
谁	讠 隹
课	讠 果
谇	讠 卒
诽	讠 非
谊	讠 宜
訚	门 言
调	讠 周
谄	讠 臽
谆	讠 享
諅	其 言
谈	讠 炎
诿	讠 委
请	讠 青
诤	讠 争
诹	讠 取
諐	侃 言
诼	讠 豖
谅	讠 京
论	讠 仑
谂	讠 念
谀	讠 臾
谍	讠 枼
谞	讠 胥
谝	讠 扁
谥	讠 兮 皿
诨	讠 军
谔	讠 咢
谛	讠 帝
谐	讠 皆
谏	讠 柬
諬	禾 尤 言
谕	讠 俞
谘	讠 咨
讳	讠 韦
谙	讠 音
谌	讠 甚
讽	讠 风
诸	讠 者
谚	讠 彦
谖	讠 爰
诺	讠 若
谋	讠 某
谒	讠 曷
谓	讠 胃
誊	𠔉 言
诌	讠 刍
謇	宀 井 大 言
謈	日 共 言
谎	讠 荒
謍	火 火 冖 言
谜	讠 迷
谧	讠 必 皿
谑	讠 虐
谡	讠 畟
谤	讠 旁
谦	讠 兼
谥	讠 益
讲	讠 井
谢	讠 射
谣	讠 爫 缶
謦	殸 言
谟	讠 莫
謩	莫 言
谪	讠 啇
谬	讠 翏
谫	讠 剪
讴	讠 区
謷	敖 言
谨	讠 堇
謽	強 言
谩	讠 曼
譀	訁 敢
哗	口 华
证	讠 正
譍	广 倠 言
谲	讠 矞
讥	讠 几
谮	讠 旡 旡 日
识	讠 只
谯	讠 焦
谭	讠 覃
谱	讠 普
谠	讠 当
譥	敫 言
警	敬 言
谵	讠 詹
譬	辟 言
毀	臼 土 殳
译	讠 又 二 丨
议	讠 义
譱	羊 言 言
谴	讠 遣
譶	言 言 言
护	扌 户
诪	讠 寿
誉	兴 言
读	讠 卖
谉	讠 审
变	亦 又
詟	龙 言
䜩	讠 燕
雠	雔 言
讐	隹 隹 言
谗	讠 免 冫
让	讠 上
谰	讠 阑
谶	讠 韱
讙	訁 雚
赞	先 先 贝
谳	讠 献
谷	八 人 口
谸	千 谷
谹	谷 厷
谺	谷 牙
谻	谷 卂 一
谼	谷 共
谽	谷 含
谾	谷 空
谿	奚 谷
豀	谷 奚
豁	害 谷
豂	谷 翏
豃	谷 敢
豆	一 口 丷 一
豇	豆 工
岂	山 己
豉	豆 支
豊	曲 豆
豋	夗 豆
豌	豆 宛
豍	豆 卑
竖	刂 又 立
豏	豆 兼
丰	三 丨
豑	豊 弟
豒	豐 弟
豓	豐 盇
豔	豐 盍
豕	一 丿 亅 丿 丿 丶 乀
豖	豕 丶
豗	兀 豕
豘	豕 屯
豙	立 豕
豚	月 豕
豛	豕 殳
豜	豕 开
豝	豕 巴
豞	豕 句
豟	豕 戹
豠	豕 且
象	刀 冖 丨 豕
豢	丷 夫 豕
豣	豕 幵
豤	豕 艮
豥	豕 亥
豦	虍 豕
豧	豕 甫
豨	豕 希
豩	豕 豕
豪	亠 口 冖 豕
豫	予 象
猪	犭 者
豭	豕 叚
豯	豕 奚
豰	士 冡 殳
豱	豕 昷
豲	豕 原
豳	豕 山 豕
豴	豕 啇
豮	豕 贲
豷	豕 壹
豸	丿 丶 丶 丿 亅 丿 丿
豹	豸 勺
豺	豸 才
豻	豸 干
豼	豸 比
豽	豸 內
豾	豸 丕
豿	豸 句
貀	豸 出
貁	豸 穴
貂	豸 召
貃	豸 白
貄	豸 聿
貅	豸 休
貆	豸 亘
貇	豸 艮
貈	豸 舟
貉	豸 各
貊	豸 百
貋	豸 旱
貌	豸 白 儿
狸	犬 里
貎	豸 兒
貏	豸 卑
貐	豸 俞
貑	豸 叚
貒	豸 耑
猫	犭 苗
貔	豸 囟 比
貕	豸 奚
貖	豸 益
獏	犭 莫
獾	犭 雚
貜	豸 矍
贝	冂 人
贞	卜 贝
贠	厶 贝
负	刀 贝
财	贝 才
贡	工 贝
貣	弋 貝
贫	分 贝
货	化 贝
贩	贝 反
贪	今 贝
贯	母 贝
责	丰 贝
贮	贝 宀 一
贳	世 贝
貱	貝 皮
赀	此 贝
贰	弋 二 贝
贵	中 一 贝
贬	贝 乏
买	乛 头
贷	代 贝
贶	贝 兄
费	弗 贝
贴	贝 占
贻	贝 台
贸	卯 贝
贺	加 贝
贲	十 艹 贝
赂	贝 各
赁	任 贝
贿	贝 有
赅	贝 亥
资	次 贝
贾	覀 贝
贼	贝 戎
贱	贝 戋
赈	贝 辰
赊	贝 佘
宾	宀 兵
賔	宀 眉 八
赇	贝 求
赒	贝 周
赉	来 贝
赐	贝 易
赏	尚 贝
赔	贝 咅
赓	庚 贝
贤	丨 丨 又 贝
卖	十 买
贱	贝 戋
赋	贝 武
赕	贝 炎
质	厂 十 贝
赍	十 人 人 冖 贝
账	贝 长
赌	贝 者
赖	束 负
赗	贝 冒
赚	贝 兼
赙	贝 尃
购	贝 勾
赛	宀 井 大 贝
贽	执 贝
赘	敖 贝
赟	斌 贝
赠	贝 曾
赞	先 先 贝
赝	厂 亻 隹 贝
赡	贝 詹
赢	亡 口 月 贝 凡
赆	贝 尽
赃	贝 庄
赑	贝 贝 贝
赎	贝 卖
赝	厂 亻 隹 贝
赣	立 早 夂 工 贝
赃	贝 庄
赤	土 丿 亅 八
赥	赤 欠
赦	赤 攵
赧	赤 卩 又
赨	赤 虫
赩	赤 色
赫	赤 赤
赪	赤 贞
赭	赤 者
赮	赤 叚
赯	赤 唐
走	十 疋
赱	土 丷 乀
赲	走 力
赳	走 丩
赴	走 卜
起	走 己
赸	走 山
赹	走 匀
赺	走 今
赻	走 少
赼	走 欠
赽	走 夬
赾	走 斤
赿	走 氐
趀	走 丿 ㇉ 丨 丿
趁	走 人 彡
趂	走 尔
趃	走 失
趄	走 且
超	走 召
趆	走 氐
趇	走 立
趈	走 占
趉	走 出
越	走 戉
趌	走 吉
趍	走 多
趎	走 朱
趏	走 舌
趐	走 羽
趑	走 次
趒	走 兆
趓	走 朵
趔	走 列
赶	走 干
趖	走 坐
趗	走 足
趘	走 尾
赵	走 乂
趚	走 束
趛	走 金
趜	走 匊
趝	走 念
趞	走 昔
趟	走 尚
趠	走 卓
趡	走 崔
趢	走 录
趣	走 取
趤	走 宕
趥	走 酋
趦	走 咨
趧	走 是
趋	走 刍
趩	走 異
趪	走 黄
趭	走 焦
趮	走 喿
趯	走 翟
趱	走 赞
足	口 卜 人
趴	足 八
趵	足 勺
趶	足 于
趷	足 乞
趹	足 夬
趺	足 夫
趻	足 今
趼	足 开
趽	足 方
趾	足 止
趿	足 及
跀	足 月
跁	足 巴
跂	足 支
跅	足 斥
跆	足 台
跇	足 世
跈	足 人 彡
跉	足 令
跊	足 未
跋	足 犮
跌	足 失
跍	足 古
跎	足 它
跏	足 加
跐	足 此
跑	足 包
跒	足 可
跓	足 主
跔	足 句
跕	足 占
跖	足 石
跗	足 付
跘	足 半
跙	足 且
跚	足 册
跛	足 皮
跜	足 尼
距	足 巨
跟	足 艮
跠	足 夷
迹	辶 亦
跢	足 多
跣	足 先
跤	足 交
跺	足 朵
跦	足 朱
跧	足 全
跨	足 夸
跩	足 曳
跪	足 危
跫	巩 足
跬	足 圭
跭	足 夅
跮	足 至
路	足 各
跰	足 并
跱	足 寺
跲	足 合
跳	足 兆
跴	足 西
跺	足 朵
跼	足 局
跽	足 忌
跾	攸 足
跿	足 走
踀	足 足
踂	足 耴
踃	足 肖
踄	足 步
踅	折 足
踆	足 夋
踇	足 每
踈	足 束
踉	足 良
踋	足 却
踍	足 孝
踎	足 否
踏	足 沓
践	足 戋
踑	足 其
踒	足 委
踓	足 隹
踔	足 卓
踕	足 疌
踖	足 昔
踗	足 念
踘	足 匊
踙	足 取
踛	足 坴
踜	足 夌
踝	足 果
踞	足 居
踟	足 知
踠	足 宛
踡	足 卷
踢	足 易
踣	足 咅
踤	足 卒
踥	足 妾
踦	足 奇
踧	足 叔
踨	足 從
踩	足 采
踫	足 並
踮	足 店
踰	足 俞
踱	足 度
踲	足 盾
踳	足 春
踊	足 甬
踵	足 重
踶	足 是
踷	足 者
踸	足 甚
踹	足 耑
踺	足 建
踽	足 禹
踾	足 畐
踿	足 秋
蹀	足 枼
蹁	足 扁
蹂	足 柔
蹃	足 若
蹄	足 帝
蹅	足 查
蹆	足 退
蹇	宀 井 大 足
蹈	足 舀
蹉	足 差
蹊	足 奚
蹋	足 日 羽
跄	足 仓
蹍	足 展
蹎	足 真
蹏	足 虒
蹐	足 脊
蹓	足 留
蹔	斬 足
跸	足 毕
蹖	足 舂
蹗	足 鹿
蹘	足 翏
蹙	戚 足
蹚	足 堂
蹜	足 宿
蹝	足 徙
蹟	辶 亦 迹
蹠	足 庶
蹢	足 啇
蹒	足 艹 两
踪	足 宗
蹦	足 崩
蹧	足 曹
蹨	足 然
蹩	敝 足
蹫	足 矞
蹬	足 登
蹭	足 曾
蹮	足 覀 大 己
蹯	足 番
蹱	足 童
蹲	足 尊
蹴	足 就
蹵	就 足
蹶	足 厥
蹷	厥 足
蹸	足 粦
蹹	足 翕
跷	足 尧
蹼	足 菐
蹽	足 尞
蹾	足 敦
躁	足 喿
跶	足 达
躃	足 辟
躄	辟 足
躅	足 蜀
躆	足 豦
躇	足 著
躈	足 敫
趸	万 足
踌	足 寿
跻	足 齐
躌	足 舞
跃	足 夭
躐	足 巤
踯	足 郑
跞	足 乐
踬	足 质
躔	足 廛
蹰	足 厨
躖	足 丨 二 幺 幺 幺 幺
跹	足 迁
躛	衞 足
躞	足 燮
躟	足 襄
躠	薛 足
蹑	足 聂
躣	足 瞿
躤	足 藉
蹿	足 窜
躜	足 赞
躨	足 夔
躩	足 矍
躏	足 蔺
身	丶 且 丿
躬	身 弓
躭	身 冘
躰	身 本
躲	身 朵
躲	身 朵
躳	身 吕
躴	身 良
躶	身 果
躷	身 委
躸	身 奇
躹	身 匊
躺	身 尚
躽	身 匽
躿	身 康
躯	身 区
軆	身 豐
车	一 𠃋 十
轧	车 乚
轨	车 九 軌
军	冖 车
轪	车 大
轩	车 干
轫	车 刃
轭	车 厄
软	车 欠
转	车 专
轷	车 乎
軩	車 台
轸	车 人 彡
轱	车 古
轴	车 由
轵	车 只
轺	车 召
轲	车 可
轶	车 失
轻	车 圣
轼	车 式
较	车 交
辂	车 各
辁	车 全
辀	车 舟
载	土 戈 车
轾	车 至
辆	车 两
辄	车 耴
辅	车 甫
轻	车 圣
辆	车 两
辎	车 甾
辉	车 军
辋	车 罔
辍	车 叕
辊	车 昆
辇	夫 夫 车
辈	非 车
轮	车 仑
辌	车 京
辑	车 口 耳
辏	车 奏
输	车 俞
辐	车 畐
辒	车 昷
辗	车 展
舆	臼 车 一 八
辒	车 昷
毂	士 冖 车 殳
辖	车 害
辕	车 袁
辘	车 鹿
转	车 专
辙	车 彳 育 攵
轿	车 乔
辚	车 粦
轰	车 又 又
辔	丝 车 口
轹	车 乐
轳	车 卢
辛	立 十
辜	古 辛
辝	台 辛
辟	尸 口 辛
辠	自 辛
辡	辛 辛
辢	束 辛
辣	辛 束
辤	受 辛
辥	屮 户 乛 一 辛
办	力 八
辧	辛 刀 辛
辨	辛 丶 丿 辛
辬	辛 文 辛
辞	舌 辛
辫	辛 纟 辛
辩	辛 讠 辛
辰	厂 衣
辱	辰 寸
农	冖 
辳	林 辰
辵	彡 丨 一 人
辸	辶 乃
边	辶 力
辻	辶 十
辿	辶 山
迀	辶 干
迂	辶 于
迃	辶 亏
迄	辶 乞
迅	辶 卂
迆	辶 也
迉	辶 尸
迎	辶 卬
迋	辶 王
迍	辶 屯
迎	辶 卬
迏	辶 太
近	辶 斤
迒	辶 亢
迓	辶 牙
返	辶 反
迕	辶 午
迖	辶 犬
迗	辶 天
迠	辶 占
迡	辶 尼
迢	辶 召
迣	辶 世
迤	辶 丿 一 也
迥	辶 冋
迦	辶 加
迧	辶 申
迨	辶 台
迪	辶 由
迫	辶 白
迬	辶 主
迭	辶 失
迮	辶 乍
迯	辶 外
述	辶 术
迱	辶 它
回	囗 口
迵	辶 同
迷	辶 米
迸	辶 并
乃	丿 ㇆ ㇆
迻	辶 多
迼	辶 吉
追	辶 戶 乛 一
迾	辶 列
迿	辶 旬
退	辶 艮
送	辶 关
逃	辶 兆
逄	辶 夅
逅	辶 后
逆	辶 屰
逇	辶 地
逈	辶 向
逋	辶 甫
逌	辶 卣
逍	辶 肖
逎	辶 酉
透	辶 秀
逐	辶 豕
逑	辶 求
逓	辶 乕
途	辶 余
径	彳 圣
迳	辶 圣
逖	辶 狄
逗	辶 豆
逘	辶 矣
这	辶 文
通	辶 甬
逛	辶 狂
逜	辶 吾
逝	辶 折
逞	辶 呈
速	辶 束
造	辶 告
逡	辶 夋
逢	辶 夆
连	辶 车
逤	辶 沙
迴	辶 回
逩	辶 奔
逪	辶 昔
逫	辶 叕
迸	辶 并
逭	辶 官
逮	辶 隶
逯	辶 彔
逰	辶 手 丿 一 子
周	冂 土 口
进	辶 井
逳	辶 育
逴	辶 卓
逵	辶 坴
逶	辶 委
逷	辶 易
逸	辶 免
远	辶 元
逼	辶 畐
逽	辶 若
逾	辶 俞
迶	辶 有
遁	辶 盾
遂	辶 丷 豕
遃	辶 彦
遄	辶 耑
遆	辶 帝
遇	辶 禺
遈	辶 是
遉	辶 貞
游	氵 斿
运	辶 云
遌	辶 咢
遍	辶 扁
过	辶 寸
遏	辶 曷
遐	辶 叚
遑	辶 皇
遒	辶 酋
道	辶 首
达	辶 大
违	辶 韦
遘	辶 冓
遥	辶 爫 缶
遚	辶 叟
遛	辶 留
逊	辶 孙
遝	辶 眔
递	辶 弟
遟	辶 屖
远	辶 元
遡	辶 朔
遢	辶 日 羽
遣	辶 辵 中 一 尸 乛 一
遧	辶 章
遨	辶 敖
适	辶 舌
遫	辶 敕
遬	辶 欶
遭	辶 曹
遮	辶 庶
遯	辶 豚
迟	辶 尺
遳	辶 莝
遴	辶 粦
遵	辶 尊
绕	纟 尧
迁	辶 千
选	辶 先
遹	辶 矞
遗	辶 贵
遻	辶 口 口 屰
辽	辶 了
遽	辶 豦
遾	辶 筮
避	辶 辟
邀	辶 敫
迈	辶 万
邂	辶 解
邃	辵 穴 丷 豕
还	辶 不
邅	辶 亶
邆	辶 登
迩	辶 尔
邈	辶 貌
邉	辶 自 冖 八 口
边	辶 力
邋	辶 巤
邌	辶 黎
邍	辶 备 录
邎	辶 夕 言 系
逻	辶 罗
逦	辶 丽
邑	口 巴
邒	丁 阝
邔	己 阝
邕	巛 邑
邖	山 阝
邗	干 阝
邘	于 阝
邙	亡 阝
邚	女 阝
邛	工 阝
邞	夫 阝
邟	亢 阝
邠	分 阝
邡	方 阝
邢	开 阝
那	月 阝
邥	冘 阝
邦	丰 阝
邧	元 阝
邨	屯 阝
邩	火 阝
邪	牙 阝
邫	丰 邑
邭	句 阝
邯	甘 阝
邰	台 阝
邱	丘 阝
邲	必 阝
邳	丕 阝
邴	丙 阝
邵	召 阝
邶	北 阝
邷	瓦 阝
邸	氐 阝
邼	匡 阝
邽	圭 阝
邾	朱 阝
邿	寺 阝
郀	夸 阝
郁	有 阝
郂	亥 阝
郃	合 阝
郄	乂 厷 阝
郅	至 阝
郆	吉 阝
郇	旬 阝
郈	后 阝
郉	幵 阝
郊	交 阝
郋	自 阝
郌	圭 邑
郍	舟 阝
郎	良 阝
郔	延 阝
郕	成 阝
郖	豆 阝
郗	希 阝
郙	甫 阝
郚	吾 阝
郛	孚 阝
郜	告 阝
郝	赤 阝
郞	良 阝
郏	夹 阝
郠	更 阝
郡	君 阝
郢	呈 阝
郣	孛 阝
郤	谷 阝
部	咅 阝
郩	肴 阝
郪	妻 阝
郫	卑 阝
郬	青 阝
郭	享 阝
郯	炎 阝
郰	取 阝
郱	并 阝
郳	兒 阝
郴	林 阝
邮	由 阝
郶	咅 邑
郷	乡 艮 阝
郹	狊 阝
郺	多 邕
郻	目 丨 一 巛 阝
都	者 阝
郾	匽 阝
郿	眉 阝
鄀	若 阝
鄁	背 阝
鄂	咢 阝
鄃	俞 阝
鄄	垔 阝
鄅	禹 阝
郓	军 阝
鄇	侯 阝
鄈	癸 阝
乡	𠃋 𠃋 丿
鄊	乡 耶 阝
鄋	叟 阝
鄌	唐 阝
鄍	冥 阝
鄎	息 阝
鄏	辱 阝
鄐	畜 阝
邹	刍 阝
鄓	臭 阝
邬	乌 阝
乡	𠃋 𠃋 丿
郧	员 阝
鄗	高 阝
鄘	庸 阝
鄙	啚 阝
鄚	莫 阝
鄛	巢 阝
鄜	鹿 阝
鄝	翏 阝
鄞	堇 阝
鄠	雩 阝
鄢	焉 阝
鄣	章 阝
鄤	曼 阝
邓	又 阝
鄨	敝 邑
鄫	曾 阝
郑	阝 邑
鄯	善 阝
邻	令 阝
鄱	番 阝
郸	单 阝
邺	业 阝
鄵	喿 阝
郐	会 阝
鄷	豊 阝
鄹	聚 阝
邝	广 阝
鄽	廛 阝
鄾	憂 阝
酀	燕 阝
酁	毚 阝
酃	霝 阝
酄	雚 阝
酅	巂 阝
酆	豐 阝
酂	赞 阝
郦	丽 阝
酉	西 一
酊	酉 丁
酋	丷 酉
酌	酉 勺
配	酉 己
酎	酉 寸
酏	酉 也
酐	酉 干
酑	酉 于
酒	氵 酉
酓	今 酉
酔	酉 卆
酕	酉 毛
酖	酉 冘
酗	酉 凶
酘	酉 殳
酙	酉 斗
酚	酉 分
酞	酉 太
酟	酉 占
酠	酉 可
酡	酉 它
酢	酉 乍
酣	酉 甘
酤	酉 古
酥	酉 禾
酧	酉 守
酨	土 戈 酉
酩	酉 名
酪	各 酉
酫	酉 全
酬	酉 州
酭	酉 有
酮	酉 同
酯	酉 旨
酰	酉 先
酲	酉 呈
酳	酉 幺 月
酴	酉 余
酵	酉 孝
酶	酉 每
酷	酉 告
酸	酉 夋
酹	酉 寽
酺	酉 甫
酻	酉 孚
酼	酉 巟
醀	酉 隹
醁	酉 彔
醂	酉 林
腌	月 奄
醄	酉 匋
醅	酉 咅
醆	酉 戔
醇	酉 享
醈	酉 炎
醉	酉 卒
醊	酉 叕
醋	酉 昔
醌	酉 昆
醍	酉 是
醎	酉 咸
醏	酉 者
醐	酉 胡
醑	酉 胥
醒	酉 星
醓	酉 冘 皿
醔	秋 酉
醕	酉 亯
醖	酉 昷
酦	酉 发
醘	酉 盍
醙	酉 叟
醚	酉 迷
醛	酉 荃
丑	㇆ 一 丨 一
醝	酉 差
酝	酉 云
醠	酉 盎
醡	酉 窄
醢	酉 右 皿
醣	酉 唐
酱	丬 夕 酉
醥	酉 票
醨	酉 离
醩	酉 曹
醪	酉 翏
医	匚 矢
酱	丬 夕 酉
醭	酉 菐
醮	酉 焦
醯	酉 巟 皿
醰	酉 覃
酦	酉 发
醳	酉 睪
醴	酉 豊
醵	酉 豦
醷	酉 意
醸	酉 六 井 一 
醹	酉 需
醺	酉 熏
醼	酉 燕
醽	酉 霝
醾	酉 糜
醿	酉 縻
酿	酉 良
衅	血 半
釂	酉 爵
酾	酉 丽
釄	酉 靡
酽	酉 严
釆	丿 米
采	爫 木
释	釆 又 二 丨
釉	釆 由
释	釆 又 二 丨
里	田 土
重	丿 一 里
野	里 予
量	曰 一 里
厘	厂 里
金	人 王 丷
钅	人 王 丷 釒
钆	钅 乚
钇	钅 乙
钌	钅 了
钊	钅 刂
钉	钅 丁
钋	钅 卜
釜	父 金
针	钅 十
釡	八 金
钓	钅 勺
钐	钅 彡
釦	钅 口
钏	钅 川
钒	钅 凡
釭	釒 工
钗	钅 叉
钍	钅 土
钕	钅 女
钎	钅 千
钯	钅 巴
钫	钅 方
钘	钅 开
钭	钅 斗
钚	钅 不
钠	钅 内
钝	钅 屯
钩	钅 勾
钤	钅 今
钣	钅 反
钑	钅 及
钞	钅 少
钮	钅 丑
钧	钅 勻
钙	钅 丐
钬	钅 火
钛	钅 太
钪	钅 亢
铎	钅 又 二 丨
铌	钅 尼
铈	钅 市
钶	钅 可
铃	钅 令
钴	钅 古
钹	钅 犮
铍	钅 皮
钰	钅 玉
钸	钅 布
铀	钅 由
钿	钅 田
钾	钅 甲
铁	钅 失
钜	钅 巨
铊	钅 它
铉	钅 玄
铇	钅 包
铋	钅 必
鉏	釒 且
铂	钅 白
钷	钅 叵
钳	钅 甘
铆	钅 卯
铅	钅 几 口
钺	钅 戉
钵	钅 本
钩	钅 勾
钲	钅 正
钼	钅 目
钽	钅 旦
矿	石 广
铏	钅 刑
铰	钅 交
铒	钅 耳
铬	钅 各
铪	钅 合
银	钅 艮
铳	钅 充
铜	钅 同
铚	钅 至
銐	列 金
铣	钅 先
铨	钅 全
铢	钅 朱
铭	钅 名
铫	钅 兆
铦	钅 舌
衔	行 钅
铑	钅 老
铷	钅 如
铱	钅 衣
铟	钅 因
铵	钅 安
铥	钅 丢
铕	钅 有
铯	钅 色
铐	钅 考
钱	钅 戋
铞	钅 吊
锐	钅 兑
销	钅 肖
锈	钅 秀
锑	钅 弟
锉	钅 坐
铝	钅 吕
锒	钅 良
锌	钅 辛
钡	钅 贝
铤	钅 廷
铗	钅 夹
锋	钅 夆
铻	钅 吾
锊	钅 寽
锓	钅 彐 冖 又
铘	钅 邪
锄	钅 助
锃	钅 呈
锔	钅 局
锇	钅 我
铓	钅 芒
铺	钅 甫
锐	钅 兑
铖	钅 成
锆	钅 告
锂	钅 里
铽	钅 忒
铸	钅 寿
锍	钅 亠 厶 川
锯	钅 居
鋻	臤 金
钢	钅 冈
锞	钅 果
錃	波 金
录	彐 水
錅	禾 勹 丿 金
锖	钅 青
锫	钅 咅
锩	钅 卷
铔	钅 亚
锥	钅 隹
锕	钅 阿
锟	钅 昆
錖	叔 金
锤	钅 垂
锱	钅 甾
铮	钅 争
锛	钅 奔
锬	钅 炎
锭	钅 定
锜	钅 奇
钱	钅 戋
锦	钅 帛
锚	钅 苗
锠	钅 昌
锡	钅 易
锢	钅 固
错	钅 昔
录	彐 水
锰	钅 孟
表	丰 
铼	钅 来
锝	钅 日 一 寸
锨	钅 欣
锪	钅 忽
钔	钅 门
锴	钅 皆
锳	钅 英
炼	火 东 一
锅	钅 呙
镀	钅 度
锷	钅 咢
铡	钅 则
鍙	洪 金
钖	钅 弓 丿 丿
锻	钅 段
锽	钅 皇
锸	钅 臿
锲	钅 契
锘	钅 若
锹	钅 秋
锾	钅 爰
鍳	臣 丿 一 丶
键	钅 建
锶	钅 思
钟	钅 中
锺	钅 重
镁	钅 美
锿	钅 哀
镅	钅 眉
镑	钅 旁
镕	钅 容
锁	钅 小 贝
枪	木 仓
镉	钅 鬲
锤	钅 垂
镈	钅 尃
镃	钅 兹
钨	钅 乌
蓥	艸 冖 金
镏	钅 留
铠	钅 岂
铩	钅 杀
锼	钅 叟
镐	钅 高
镇	钅 真
镇	钅 真
镒	钅 益
镋	钅 党
镍	钅 臬
镓	钅 家
镌	钅 隽
镎	钅 拿
镞	钅 族
镟	钅 旋
链	钅 连
鏊	敖 金
镆	钅 莫
镙	钅 累
镠	钅 翏
镝	钅 啇
鏖	鹿 金
铿	钅 坚
锵	钅 将
镗	钅 堂
镘	钅 曼
镛	钅 庸
铲	钅 产
镜	钅 竟
镖	钅 票
镂	钅 娄
錾	斩 金
镚	钅 朋
铧	钅 华
镤	钅 菐
镪	钅 强
锈	钅 秀
铙	钅 尧
铴	钅 汤
镣	钅 尞 鐐
铹	钅 劳
镦	钅 敦
镡	钅 覃
钟	钅 中
镫	钅 登
鐜	享 金
镢	钅 厥
镨	钅 普
锎	钅 开
锏	钅 间
镄	钅 费
镌	钅 隽
镰	钅 廉
镯	钅 蜀
镭	钅 雷
铁	钅 失
镮	钅 睘
铎	钅 又 二 丨
铛	钅 当
鐾	辟 金
镱	钅 意
铸	钅 寿
镬	钅 蒦
镔	钅 宾
鉴	丨 丨 丿 一 丶 金
鉴	丨 丨 丿 一 丶 金
镲	钅 察
锧	钅 质
钻	钅 占
矿	石 广
镴	钅 巤
铄	钅 乐
镳	钅 鹿 灬
镥	钅 鲁
鑫	金 金 金
镧	钅 阑
钥	钅 月
镵	钅 毚
镶	钅 襄
镊	钅 聂
镩	钅 窜
锣	钅 罗
钻	钅 占
銮	亦 金
凿	丵 凵
镋	钅 党
镸	三 丨 一 厶
镹	镸 久
镺	镸 夭
镻	镸 失
镼	镸 屈
镽	镸 尞
门	丶 丨 ㇆
闩	门 一
闪	门 人
闫	门 三
闬	门 干
闭	门 才
开	一 廾
闶	门 亢
闳	门 厷
闰	门 王
闲	门 木
闲	门 木
间	门 日
闵	门 文
斗	丶 丶 十
闸	门 甲
闹	门 市
阂	门 亥
关	丷 天
阁	门 各
合	人 一 口
阀	门 伐
闺	门 圭
闽	门 虫
阃	门 困
阆	门 良
闾	门 吕
阅	门 兑
阅	门 兑
阊	门 昌
阉	门 奄
阎	门 臽
阏	门 於
阍	门 昏
阈	门 或
阌	门 受
阒	门 狊
板	木 反
闱	门 韦
阔	门 活
阕	门 癸
阑	门 柬
阇	门 者
阗	门 真
阘	门 日 羽
闿	门 岂
阖	门 盍
阙	门 欮
闯	门 马
关	丷 天
斗	丶 丶 十
关	丷 天
阚	门 敢
阓	门 贵
阐	门 单
辟	尸 口 辛
阛	门 睘
闼	门 达
阞	阝 力
阠	阝 卂
阡	阝 千
阢	阝 兀
阣	阝 乞
阤	阝 也
阥	阝 水
阦	阝 火
阧	阝 斗
阨	阝 厄
阩	阝 升
阪	阝 反
阫	阝 不
阬	阝 亢
阭	阝 允
阮	阝 元
阯	阝 止
阰	阝 比
阱	阝 井
防	阝 方
阷	阝 正
阸	阝 戹
阹	阝 去
阺	阝 氐
阻	阝 且
阼	阝 乍
阽	阝 占
阾	阝 令
阿	阝 可
陀	阝 它
陁	阝 丿 一 也
陂	阝 皮
陃	阝 丙
附	阝 付
陊	阝 多
陋	阝 丨 一 丙
陌	阝 百
降	阝 夅
陎	阝 朱
陏	阝 有
限	阝 艮
陑	阝 而
陒	阝 危
陓	阝 夸
陔	阝 亥
陖	阝 夋
陗	阝 肖
陉	阝 圣
陙	阝 辰
陚	阝 武
陛	阝 坒
陕	阝 夹
陕	阝 夹
升	丿 十 丿
陟	阝 步
陠	阝 甫
陡	阝 走
院	阝 完
阵	阝 车
除	阝 余
陷	阝 臽
陧	阝 圼
陪	阝 咅
陫	阝 非
陬	阝 取
陭	阝 奇
陮	阝 隹
阴	阝 月
陱	阝 匊
陲	阝 垂
陈	阝 东
陴	阝 卑
陵	阝 夌
陶	阝 匋
陷	阝 臽
陆	阝 击
险	阝 佥
陻	阝 垔
陼	阝 者
阳	阝 日
陾	阝 耎
隀	阝 重
隁	阝 匽
隂	阝 人 镸
隃	阝 俞
隄	阝 是
隅	阝 禺
隆	阝 夂 生
隇	阝 威
隈	阝 畏
隉	阝 臼 土
队	阝 人
隋	阝 左 月
隌	阝 音
隍	阝 皇
阶	阝 介
隒	阝 兼
隓	阝 左 左
隔	阝 鬲
陨	阝 员
隖	阝 烏
隗	阝 鬼
隘	阝 益
隙	阝 小 日 小
隚	阝 堂
际	阝 示
障	阝 章
隞	阝 敖
隟	阝 巢
隐	阝 急
隣	阝 粦
隤	阝 貴
隥	阝 登
隦	阝 辟
隧	阝 遂
随	阝 迶
隩	阝 奧
险	阝 佥
隭	阝 需
隐	阝 急
隳	阝 隋 人 心
陇	阝 龙
隶	彐 水
隹	人 主 一
隺	冖 隹
只	口 八
隼	隹 十
隽	隹 乃
隿	弋 隹
雀	少 隹
雁	厂 亻 隹
雂	今 隹
雃	开 隹
雄	厷 隹
雅	牙 隹
集	隹 木
雇	户 隹
萑	艸 隹
雉	矢 隹
雊	句 隹
隽	隹 乃
雌	此 隹
雍	亠 乡 隹
雎	且 隹
雐	虍 隹
杂	九 朩
雒	各 隹
雓	余 隹
雔	隹 隹
雕	周 隹
虽	口 虫
雗	十 日 十 丿 一 隹
雘	丹 蒦
双	又 又
雚	艸 口 口 隹
雏	刍 隹
杂	九 木
雝	邕 隹
鸡	又 鸟
雟	屮 隹 冏
雡	翏 隹
离	离 隹 離
难	又 隹
雤	𦥯 隹
雥	隹 隹 隹
雦	隹 隹 隹
雧	集 集 集 木
雨	一 冂 丨 丶 丶 丶 丶
雩	雨 亏
雪	雨 彐
雫	雨 下
雬	雨 木
雭	雨 及
雮	雨 毛
雯	雨 文
雰	雨 分
雱	雨 方
云	二 厶
雴	雨 立
雵	雨 央
零	雨 令
雷	雨 田
雸	雨 甘
雹	雨 包
雺	雨 矛
电	日 乚
雼	雨 石
雽	雨 乎
雿	雨 兆
需	雨 而
霂	雨 沐
霃	雨 沈
霄	雨 肖
霅	雨 言
霆	雨 廷
震	雨 辰
霈	雨 沛
霉	雨 母
霊	雨 一 亚
霋	雨 妻
霌	雨 周
霍	雨 隹
霎	雨 妾
霏	雨 非
霐	雨 泓
霑	雨 沾
霒	雲 今
霓	雨 兒
霔	雨 注
霕	雲 屯
霖	雨 林
霘	雨 洞
霙	雨 英
霚	雨 敄
霛	雨 弓 弓 弓
霜	雨 相
霝	雨 口 口 口
霞	雨 叚
霟	雨 洪
霠	雨 立 今
霡	雨 脉
霤	雨 留
霥	雨 冡
霦	雨 彬
雾	雨 务
霨	雨 尉
霩	雨 郭
霪	雨 氵 爫 壬
霫	雨 習
霬	雨 異
霮	雨 湛
霯	雨 登
霰	雨 散
霱	雨 矞
露	雨 路
霳	雨 隆
霵	雨 戢
霶	雨 滂
霷	雨 晹
霸	雨 革 月
霹	雨 辟
霺	雨 微
霼	雲 氣
霁	雨 齐
霾	雨 貍
霿	雨 敄 目
靀	雨 蒙
靁	雨 畾
雳	雨 历
靃	雨 隹 隹
霭	雨 谒
叇	云 逮
灵	彐 火
叆	云 爱
靊	雨 豐
靐	雷 雷 雷
青	三 丨 月
青	丰 月
靕	正 青
靖	立 青
靗	青 光
靘	青 色
靓	青 见
靛	青 定
静	青 争
靔	青 气
非	三 丿 丨 三
靟	非 毛
靠	告 非
靡	麻 非
面	一 丶 囗 丨 丨 一 一
靣	一 丶 回
靤	面 包
腼	月 面
靥	厌 面
革	廿 口 十
靪	革 丁
靫	革 叉
靬	革 干
靭	革 刃
靮	革 勺
靯	革 土
靰	革 兀
靱	革 刄
靲	革 今
靳	革 斤
靴	革 化
靵	革 丑
靶	革 巴
靷	革 引
靸	革 及
靹	革 內
靺	革 末
靻	革 且
靼	革 旦
靽	革 半
靾	革 世
靿	革 幼
鞀	革 召
鞁	革 皮
鞂	革 和
鞃	革 弘
鞄	革 包
鞅	革 央
鞇	革 因
鞈	革 合
鞉	革 兆
鞊	革 吉
鞋	革 圭
鞌	安 革
鞍	革 安
鞎	革 艮
巩	工 凡
鞓	革 呈
鞔	革 免
鞕	革 更
鞖	革 妥
鞗	攸 革
鞘	革 肖
鞙	革 肙
鞚	革 空
鞛	革 咅
鞜	革 沓
鞝	革 尚
鞞	革 卑
鞟	革 享
鞠	革 勹 米
鞡	革 拉
鞢	革 枼
鞣	革 柔
鞤	封 革
鞥	革 弇
秋	禾 火
鞧	革 酋
鞨	革 曷
鞩	革 削
鞪	敄 革
鞫	革 訇
鞬	革 建
鞭	革 便
鞮	革 是
鞱	革 舀
鞲	革 冓
鞳	革 荅
鞴	革 艸 厂 用
鞵	革 奚
鞶	般 革
鞷	鬲 革
鞹	革 郭
鞒	革 乔
韀	革 廌
缰	纟 畺
韂	革 詹
鞑	革 达
韄	革 蒦
千	丿 十
韈	革 蔑
鞯	革 荐
韦	二 ㇆ 丨
韧	韦 刃
韨	韦 友 丶
韩	十 日 十 韦
韪	是 韦
韬	韦 舀
韝	韋 冓
韫	韦 昷
韭	非 一
韮	艸 韭
韯	𢦏 韭
韰	歺 又 韭
韱	人 人 戈 韭
齑	文 丿 丨 韭
音	立 曰
韴	音 帀
韶	音 召
韷	音 出
韸	音 夆
韹	音 皇
韺	音 英
韵	音 匀
韼	音 逢
韽	酓 音
韾	殸 音
响	向 口
頀	音 蒦
页	一 丶 贝
顶	丁 页
顷	匕 页
项	工 页
顺	川 页
顸	干 页
须	彡 页
顼	王 页
顾	厄 页
颂	公 页
颀	斤 页
颃	亢 页
预	予 页
顽	元 页
颁	分 页
顿	屯 页
颇	皮 页
领	令 页
頙	正 頁
颌	合 页
颉	吉 页
颐	匸 丨 口 丨 页
颏	亥 页
頫	兆 頁
颊	夹 页
头	丶 丶 大
颒	水 廾 页
颊	夹 页
颋	廷 页
颕	匕 示 页
頶	告 頁
颔	含 页
颈	圣 页
颓	秃 页
频	步 页
颓	秃 页
颗	果 页
顇	卒 頁
题	是 页
额	客 页
颚	咢 页
颜	彦 页
颙	禺 页
颛	耑 页
颜	彦 页
囟	丶 囗 乂
愿	原 心
颡	桑 页
颠	真 页
颠	真 页
类	米 大
颟	艸 两 页
颢	景 页
顾	厄 页
颤	亶 页
颥	需 页
显	日 业
颦	频 卑
颅	卢 页
颞	聂 页
颧	雚 页
风	几 乂
飐	风 占
飑	风 包
飒	立 风
台	厶 口
刮	舌 刂
飓	风 具
飔	风 思
飏	风 弓 丿 丿
飖	爫 缶 风
飕	风 叟
飗	风 留
飘	票 风
飙	犬 犬 犬 风
飚	风 猋
飞	乙 丷
飜	番 飛
食	人 良
饣	人 良 飠
飡	冫 食
饥	饣 几
饤	饣 丁
饦	饣 乇
饨	饣 屯
饪	饣 壬
饫	饣 夭
飬	丷 夫 良
饬	饣 丿 一 力
饭	饣 反
饮	饣 欠
饴	饣 台
飸	号 食
飺	此 食
饲	饣 司
饱	饣 包
饰	饣 丿 一 巾
饳	饣 出
餀	食 艾
饺	饣 交
饸	饣 合
饼	饣 并
餈	次 食
饷	饣 向
养	羊 乀 丿 丨
饵	饣 耳
饹	饣 各
饻	饣 衣
餐	歺 又 食
饽	饣 孛
馁	饣 妥
饿	饣 我
馂	饣 夋
饾	饣 豆
余	人 于 八
馀	饣 余
肴	乂 一 丿 肉
馄	饣 昆
馃	饣 果
饯	饣 戋
饼	饣 并
馅	饣 臽
餥	非 食
馆	饣 官
糊	米 胡
餮	殄 食
饧	饣 弓 丿 丿
喂	口 畏
馉	饣 骨
馇	饣 查
馎	饣 尃
糕	米 羔
饩	饣 气
馏	饣 留
馊	饣 叟
馌	饣 盍
馍	饣 莫
馒	饣 曼
馐	饣 羞
馑	饣 堇
馓	饣 散
馈	饣 贵
馔	饣 巽
饏	敢 食
饥	饣 几
饶	饣 尧
饕	號 食
飨	食 乡
饚	食 蓋
餍	厌 食
馋	饣 免 冫
馕	饣 囊
首	丷 一 丶 目
馗	九 首
馘	首 或
香	禾 日
馚	香 分
馛	香 犮
馜	香 尼
馝	香 必
馞	香 孛
馟	香 孚
馠	香 含
馡	香 非
馣	香 奄
馤	香 曷
馥	香 复
馦	香 兼
馧	香 昷
馨	殸 香
馫	香 香 香
驭	马 又
冯	冫 马
馯	馬 干
驮	马 大
驰	马 也
驯	马 川
驲	马 日
馾	馬 冘
驳	马 爻
驱	马 区
驻	马 主
驽	奴 马
驹	马 句
驵	马 且
驾	加 马
骀	马 台
驸	马 付
驶	马 史
驼	马 它
驷	马 四
骂	口 口 马
骈	马 并
骇	马 亥
骃	马 因
骆	马 各
骎	马 彐 冖 又
骏	马 夋
骋	马 由 丂
骍	马 辛
骓	马 隹
骈	马 并
骔	马 宗
骒	马 果
骑	马 奇
骐	马 其
验	马 佥
骛	敄 马
骗	马 扁
骙	马 癸
骞	马 宀 井 大
骘	陟 马
骝	马 留
腾	月 丷 夫 马
驺	马 刍
骚	马 蚤
骟	马 扇
骡	马 累
蓦	莫 马
骜	敖 马
骖	马 参
骠	马 票
骢	马 悤
驱	马 区
骅	马 华
骕	马 肃
骁	马 尧
骣	马 孱
骄	马 乔
验	马 佥
惊	忄 京
驿	马 又 二 丨
骤	马 聚
驴	马 户
骧	马 襄
骥	马 冀
骦	马 霜
骊	马 丽
骉	马 马 马
骩	骨 九
骪	骨 凡
骫	骨 丸
骬	骨 于
骭	骨 干
骮	骨 戈
肮	肉 亢
骰	骨 殳
骱	骨 介
骲	骨 包
骳	骨 皮
骴	骨 此
骵	骨 本
骶	骨 氐
骷	骨 古
骸	骨 亥
骹	骨 交
骺	骨 后
骻	骨 夸
骼	骨 各
骽	骨 妥
骾	骨 更
骿	骨 并
髀	骨 卑
髁	骨 果
髂	骨 客
髃	骨 禺
髄	骨 迶
髆	骨 尃
髇	骨 高
髈	骨 旁
髉	骨 隺
髊	骨 差
髍	骨 麻
髎	骨 翏
髅	骨 娄
脏	月 庄
髓	骨 遀
体	亻 本
髌	骨 宾
髋	骨 宽
高	亠 口 冂 口
髙	亠 丨 一 一 丨 冋
髚	高 亢
髛	高 尻
髜	高 昇
髞	高 喿
髟	镸 彡
髠	髟 几
髡	髟 兀
髢	髟 也
髣	髟 方
髤	髟 木
髥	髟 冄
髦	髟 毛
髧	髟 冘
髨	髟 元
髩	髟 丏
髪	髟 友
髫	髟 召
髬	髟 丕
髭	髟 此
发	丿 友 丶
髯	髟 冉
髰	髟 髟 世
髱	髟 包
髲	髟 皮
髳	髟 矛
髴	髟 弗
髵	髟 而
髶	髟 耳
髷	髟 曲
髹	髟 休
髺	髟 舌
髻	髟 吉
髼	髟 夆
髽	髟 坐
髾	髟 肖
髿	髟 沙
鬀	髟 弟
鬁	髟 利
鬂	髟 兵
鬃	髟 宗
鬄	髟 易
鬅	髟 朋
松	木 公
鬇	髟 争
鬈	髟 卷
鬉	髟 凶 八 夂
鬊	髟 春
鬋	髟 前
鬌	髟 左 月
胡	古 月
鬎	髟 剌
鬏	髟 秋
鬐	髟 耆
鬑	髟 廉
鬒	髟 真
鬔	髟 逢
鬕	髟 莫
鬖	髟 參
鬘	髟 曼
鬙	髟 曾
须	彡 页
鬛	髟 囗 乂 𠄌 丶 丶 𠄌 丶 丶 乀
鬟	髟 睘
鬓	髟 宾
鬣	髟 巤
鬤	髟 襄
斗	丶 丶 十
斗	丶 丶 十
闹	门 市
哄	口 共
阋	门 兒
斗	丶 丶 十
鬫	鬥 敢
斗	丶 丶 十
斗	丶 丶 十
阄	门 龟
鬯	凵 乂 丶 丶 丶 丶 匕
鬰	棥 冖 鬯 彡
郁	有 阝
鬲	一 口 冂 丫 一
鬳	虍 鬲
鬴	鬲 甫
鬵	旡 旡 鬲
鬷	鬲 凶 八 夂
鬸	鬲 留
鬶	规 鬲
鬺	鬲 丿 一 昜
鬻	粥 鬲
鬼	丶 田 儿 厶
鬽	鬼 彡
鬾	鬼 支
鬿	鬼 斤
魀	鬼 介
魁	鬼 斗
魂	云 鬼
魃	鬼 犮
魄	白 鬼
魅	鬼 未
魆	鬼 戉
魈	鬼 肖
魊	鬼 或
魋	鬼 隹
魌	鬼 其
魍	鬼 罔
魉	鬼 两
魏	委 鬼
魐	鬼 兼
魑	鬼 离
魒	鬼 票
魔	麻 鬼
魖	鬼 虛
魇	厌 鬼
魙	鬼 漸
鱼	刀 田 一
鱽	鱼 刀
鱾	鱼 己
鲀	鱼 屯
鲁	鱼 日
鲂	鱼 方
鱿	鱼 尤
鲄	鱼 可
鲅	鱼 犮
鲆	鱼 平
鲌	鱼 白
鲉	鱼 由
鲏	鱼 皮
鲇	鱼 占
鲐	鱼 台
鲍	鱼 包
鲋	鱼 付
鲊	鱼 乍
鲒	鱼 吉
鲘	鱼 后
鲞	𠔉 鱼
鲕	鱼 而
鲖	鱼 同
鲔	鱼 有
鲛	鱼 交
鲑	鱼 圭
鲜	鱼 羊
鲓	鱼 考
鲪	鱼 君
鲝	羊 鱼
鲧	鱼 系
鲠	鱼 更
鲩	鱼 完
鲤	鱼 里
鲨	沙 鱼
鲬	鱼 甬
鲻	鱼 甾
鲯	鱼 其
鲭	鱼 青
鲷	鱼 周
鲴	鱼 固
鲱	鱼 非
鲵	鱼 兒
鲲	鱼 昆
鲳	鱼 昌
鲸	鱼 京
鲮	鱼 夌
鲰	鱼 取
鲶	鱼 念
鲺	鱼 虱
鲹	鱼 参
鳀	鱼 是
鲫	鱼 即
鳊	鱼 扁
鳈	鱼 泉
鲗	鱼 则
鳂	鱼 畏
鲽	鱼 枼
鳇	鱼 皇
鳅	鱼 秋
鲾	鱼 畐
鳄	鱼 咢
鳆	鱼 复
鳃	鱼 思
鳁	鱼 昷
鳒	鱼 兼
鳑	鱼 旁
鳋	鱼 蚤
鲥	鱼 时
鳏	鱼 眔
鳎	鱼 日 羽
鳐	鱼 爫 缶
鳍	鱼 耆
鳁	鱼 昷
鲢	鱼 连
鳌	敖 鱼
鳓	鱼 勒
鳘	敏 鱼
鲦	鱼 条
鲣	鱼 坚
鳗	鱼 曼
鳛	鱼 習
鳔	鱼 票
鳉	鱼 丬 夕 寸
鳙	鱼 庸
鳕	鱼 雪
鳖	鱼 敝
鳟	鱼 尊
鳝	鱼 善
鳜	鱼 厥
鳞	鱼 粦
鲟	鱼 寻
鲼	鱼 贲
鲎	丶 丶 丶 冖 鱼
鲙	鱼 会
鳣	鱼 亶
鳡	鱼 感
鳢	鱼 豊
鲿	鱼 尝
鲚	鱼 齐
鳠	鱼 蒦
鳄	鱼 咢
鲈	鱼 卢
鲡	鱼 丽
鲜	鱼 羊
鸟	勹 丶 ㇉ 一
凫	鸟 几
鸠	九 鸟
鳪	卜 鳥
凫	勹 丶 丨 ㇆ 几
鳭	刀 鳥
鸡	又 鸟
凤	几 又
鸤	尸 鸟
凤	几 又
鸣	口 鸟
鸢	弋 鸟
鸩	冘 鸟
鸨	𠤏 鸟
鸦	牙 鸟
凤	几 又
鸥	区 鸟
鴏	鳥 代
鸰	令 鸟
鸵	鸟 它
鸳	夗 鸟
鸲	句 鸟
鸮	号 鸟
鸱	氐 鸟
鴠	旦 鳥
鸪	古 鸟
鸯	央 鸟
鸭	甲 鸟
莺	艸 冖 鸟
鸸	而 鸟
鸹	舌 鸟
鸻	行 鸟
鸿	氵 工 鸟
鸽	合 鸟
鸺	休 鸟
鸼	舟 鸟
鸾	亦 鸟
鹀	巫 乌
鹃	肙 鸟
鹆	谷 鸟
鹁	孛 鸟
鹈	弟 鸟
鹅	我 鸟
鹅	我 鸟
鹄	告 鸟
鹉	武 鸟
鹌	奄 鸟
鹏	朋 鸟
鹐	臽 鸟
鹎	卑 鸟
雕	周 隹
鹊	昔 鸟
鹓	宛 鸟
鹍	昆 鸟
鸫	东 鸟
鹑	享 鸟
鹒	庚 鸟
鸡	又 鸟
鹋	苗 鸟
鹙	秋 鸟
鹕	胡 鸟
鹗	咢 鸟
鹖	曷 鸟
鹛	眉 鸟
鹕	胡 鸟
鹜	敄 鸟
鸧	仓 鸟
莺	艹 冖 鸟
鹟	翁 鸟
鹤	隺 鸟
雏	刍 隹
鹠	留 鸟
鹡	脊 鸟
鹘	骨 鸟
鹣	兼 鸟
鹚	兹 鸟
鹢	益 鸟
鹞	爫 缶 鸟
鸡	又 鸟
鹝	鬲 鸟
鷎	皋 鳥
鷐	晨 鳥
鹧	庶 鸟
鹥	殹 鸟
鸥	区 鸟
鸷	执 鸟
鹨	翏 鸟
鸶	丝 鸟
鹪	焦 鸟
鹔	肃 鸟
鹩	尞 鸟
鹫	就 鸟
鹇	闲 鸟
鹇	闲 鸟
鹬	矛 冏 鸟
鹰	广 亻 隹 鸟
鹭	路 鸟
鸴	小 冖 鸟
鹯	亶 鸟
鹱	鸟 蒦
鹲	蒙 鸟
鸬	卢 鸟
鹴	霜 鸟
鹦	婴 鸟
鹳	雚 鸟
鹂	丽 鸟
鸾	亦 鸟
卤	卜 囗 乂
硷	石 佥
咸	戊 一 口
鹾	卤 差
硷	石 佥
盐	土 卜 皿
鹿	广 乛 一 丨 丨 比
麀	鹿 匕
麁	刀 鹿
麂	鹿 几
麃	鹿 灬
麄	分 鹿
麅	鹿 包
麆	鹿 且
麇	鹿 禾
麈	鹿 主
麉	干 干 鹿
麊	米 鹿
麋	鹿 米
麌	鹿 吳
麍	鹿 巟
麎	鹿 辰
麏	鹿 君
麐	鹿 吝
麑	鹿 兒
麒	鹿 其
麓	林 鹿
麔	鹿 咎
麕	鹿 囷
麖	鹿 京
丽	一 冂 丶 冂 丶
麘	鹿 香
麙	鹿 咸
麚	鹿 叚
麛	鹿 弭
麜	鹿 栗
麝	鹿 射
麞	鹿 章
麟	鹿 粦
麠	鹿 畺
麢	鹿 霝
麣	鹿 嚴
麤	鹿 鹿 鹿
麦	丰 夂
麧	麥 乞
麨	麥 少
麸	麦 夫
面	一 丶 囗 丨 丨 一 一
麫	麥 丏
曲	囗 卄
麲	麥 見
曲	曰 丨 丨
麹	麦 匊
面	一 丶 囗 丨 丨 一 一
麺	麦 面
麻	广 林
么	丿 厶
么	丿 厶
麾	麻 毛
黀	麻 取
黁	麻 香
黄	艹 一 田 八
黅	黃 今
黆	黃 冘
黇	黃 占
黈	黄 主
黊	黄 圭
黋	黄 光
黉	小 冖 黄
黍	禾 人 水
黎	禾 勹 丿 人 水
黏	黍 占
黐	黍 离
黑	口 丷 土 灬
黑	口 丷 土 灬
黓	黑 戈
黔	黑 今
黕	黑 冘
黖	黑 旡
黗	黑 屯
默	黑 犬
黙	里 犬 灬
黚	黑 甘
黛	代 黑
黜	黑 出
黝	黑 幼
点	占 灬
黟	黑 多
黠	黑 吉
黢	黑 夋
黣	黑 每
黤	黑 奄
黥	黑 京
黦	黑 宛
黧	禾 勹 丿 黑
党	小 冖 兄
黫	黑 垔
黬	黑 咸
黭	黑 弇
黮	黑 甚
黯	黑 音
黰	黑 真
黱	月 丷 夫 黑
黪	黑 参
黳	殹 黑
霉	雨 母
黵	黑 詹
黡	厌 黑
黩	黑 卖
黹	业 八 巾 八
黺	黹 分
黻	黹 犮
黼	黹 甫
黾	口 电
鼋	元 黾
鼀	圥 黽
鼌	旦 黾
鼃	圭 黽
鼄	朱 黽
鼅	知 黽
鼆	冥 黽
鼇	敖 黽
鼈	敝 黽
鼍	嘼 电
鼊	辟 黽
鼎	目 爿 片
鼏	冖 鼎
鼐	乃 鼎
鼑	卜 鼎
鼒	才 鼎
鼓	十 豆 支
鼔	十 豆 攴
鼕	鼓 冬
鼖	十 艹 鼓
鼗	兆 鼓
鼙	鼓 卑
鼛	鼓 处 口
鼜	鼓 蚤
鼝	淵 鼓
鼞	鼓 堂
鼟	鼓 登
鼠	臼 𠄌 丶 丶 𠄌 丶 丶 乀
鼠	臼 𠄌 丶 丶 𠄌 丶 丶 乀
鼢	鼠 分
鼣	鼠 犬
鼤	鼠 文
鼥	鼠 犮
鼦	鼠 召
鼧	鼠 它
鼨	鼠 冬
鼩	鼠 句
鼪	鼠 生
鼫	鼠 石
鼬	鼠 由
鼭	鼠 寺
鼮	鼠 廷
鼯	鼠 吾
鼱	鼠 青
鼳	鼠 狊
鼹	鼠 妟
鼵	鼠 突
鼶	鼠 虒
鼷	鼠 奚
鼸	鼠 兼
鼺	鼠 畾
鼻	自 田 廾
鼼	鼻 丩
鼽	鼻 九
鼾	鼻 干
鼿	鼻 兀
齀	鼻 瓦
齁	鼻 句
齂	鼻 隶
齃	鼻 曷
齄	鼻 查
齅	鼻 臭
齆	鼻 邕
齇	鼻 虘
齉	鼻 囊
齐	文 丿 丨
斋	文 而
齌	齊 火
齑	文 丿 丨 韭
齿	止 人 凵
龀	齿 匕
龁	齿 乞
龂	齿 斤
龅	齿 包
龇	齿 此
龃	齿 且
龆	齿 召
龄	齿 令
龄	齿 令
出	山 山
龈	齿 艮
啮	口 齿
龊	齿 足
龉	齿 吾
龋	齿 禹
龌	齿 屋
龙	尤 丿
厐	厂 龙
庞	广 龙
龚	龙 共
龛	合 龙
龟	刀 电
鳖	鱼 敝
龠	人 一 口 口 口 冊
龡	龠 欠
龢	龠 禾
龣	龠 录
龤	龠 皆
刾	夹 刂
鲃	鱼 巴
鳚	鱼 尉
鳤	鱼 管
鹮	睘 鸟
㧹	扌 得
㗎	口 架
呣	口 母
嚒	口 麼
嚡	口 鞋
揤	扌 即
㓟	皮 刂
㓤	吉 刂
㕕	厶 厶
㕭	口 夭
㕸	口 立
㖠	口 奈
㖭	口 添
㗅	口 胡
㗆	口 革
㗾	口 靴
㞗	尸 求
㤻	卵 心
㦴	各 戈
㧬	巩 手
㧵	扌 否
㧺	扌 沓
㧻	扌 豖
㧼	扌 表
㧽	扌 固
㧾	扌 忽
㨀	扌 秉
㨁	扌 直
㨃	扌 享
㨄	扌 周
㨅	扌 芮
㨆	扌 林
㨇	波 手
㨈	扌 斉
㨉	扌 昬
㨊	扌 左 肉
㨋	扌 者
㨌	士 冖 手 殳
㨍	封 手
㨎	扌 耎
㨏	扌 炭
㨐	扌 保
㨒	扌 奎
㨓	扌 罕
㨔	扌 咸
㨕	扌 盈
㨗	扌 疌
㨘	扌 省
㨢	扌 能
㩒	扌 禁
㩧	扌 暴
㩻	危 支
㱦	歹 奇
㹃	非 牛
㿭	斥 皮
䂿	石 沓
䇱	竹 囗 夕
䉭	竹 巤
䉺	米 工
䍇	缶 乏
䐙	月 革
䖙	卧 虒
䞘	走 乞
䟜	足 內
䟴	足 辰
䠋	足 卑
䤚	月 里
䨣	雨 革
䨩	雨 神
䪂	革 棘
䫯	旑 頁
䭮	髟 首
䭰	香 奉
𠜱	卑 刂
𠝹	界 刂
𠮨	口 乃
𠱃	口 凹
𠱸	口 臣
𠴕	口 妙
𠵼	口 孟
𠵿	口 披
𠶧	口 店
𠸎	口 挐
𠹳	口 桀
𠺘	口 浪
𠺝	口 格
𠺫	口 料
𠻹	口 添
𠼱	口 累
𠼻	口 基
𠽤	口 戟
𠾴	口 棒
𠿭	口 滑
𡁶	口 截
𡉼	升 土
𡍚	土 林
𢃇	巾 里
𢆡	乳 年
𢠃	猄 心
𢫏	扌 冚
𢫨	扌 戎
𢭃	扌 豆
𢮁	扌 於
𢮂	扌 弦
𢮇	扌 士 母
𢮈	扌 忿
𢮉	扌 厂 兆
𢮋	扌 承
𢮍	扌 穹
𢮎	扌 虎
𢮏	手 咅
𢮐	扌 尚
𢮑	扌 彔
𢮒	扌 阜
𢮓	扌 制
𢮜	基 手
𢮝	取 手
𢯊	扌 的
𢯎	扌 肴
𢯎	扌 肴
𢯪	扌 广 屰
𢯫	扌 段
𢯮	扌 胃
𢯰	扌 律
𢯲	目 叉 手
𢯵	扌 目 夬
𢯶	扌 室
𢯹	扌 革
𢯺	扌 禹
𢯼	扌 衍
𢯽	扌 苴
𢯾	扌 冒
𢯿	扌 苞
𢰃	扌 穾
𢰅	扌 弜 一 八
𢰆	扌 苻
𢰋	扌 囗 而
𢰌 	手 网 心
𢰍	扌 亠 口 火
𢰏	扌 孚
𢰙	扌 至 寸
𢰝	扌 茂
𢰞	敃 手
𢰠	扌 幽
𢰡	扌 侯
𢰢	扌 首
𢰥	扌 苔
𢰦	扌 春
𢰧	扌 斿
𢰩	扌 兹
𢰫	扌 工 兆
𢰬	扌 隶
𢰭	扌 勇
𢰮	扌 胡
𢰯	扌 枣
𢰲	扌 眉
𢰳	扌 要
𢰴	扌 故
𢰶	扌 英
𢰷	扌 点
𢰻	扌 臼 丨 丂
𢰽	扌 急
𢰾	扌 怠
𢱁	扌 苜
𢱃	扌 科
𢱆	扌 咨
𢱈	扌 叚
𢱉	扌 歪
𢱋	扌 度
𢱍	扌 勉
𢱎	扌 拜
𢱏	扌 訂
𢱐	扌 姚
𢱑	扌 穴 爪
𢱒	扌 美
𢱓	扌 洗
𢱔	扌 盆
𢱕	扌 耷
𢱖	扌 某
𢱗	扌 苦
𢱘	扌 彥
𢱙	扌 孩
𢱛	扌 洒
𢱜	扌 待
𢱝	扌 茁
𢱞	手 茁
𢳆	扌 敖
𢴈	扌 笪
𢶤	扌 靴
𣖕	木 屏
𣚺	未 成 母
𣲷	氵 囗 又
𤆣	火 及
𤊓	火 兒
𤘅	牙 子
𤶸	疒 那
𤷈	疒 奈
𤷪	疒 孟
𤺧	疒 曾
𥄫	目 及
𥇣	目 屈
𥊼	目 牚
𥋇	目 掌
𥹉	米 囗 又
𦟌	月 展
𦢓	月 墨
𦧲	舌 累
𦧺	舌 賴
𧊅	虫 另
𧋦	虫 尾
𧘹	衤 太
𨂾	足 南
𨃩	足 扇
𨅝	足 牚
𨈓	身 小
𩩍	骨 甹
𩬎	髟 壬
㚇	凶 八 夂
𡕩	囟 儿 夂
㨑	扌 㚇
䁓	目 㚇
𥊙	目 㚇
巭	功 夫
䲞	鱼 立