亅 丁	一
乙 丂	一
乚 七	丿
一 丄	丨
丨 丅	一
刀 万	一
乂 丈	一
一 三	一 一
一 上	丶 丨
丶 下	一 丨
丨 丌	一 丿
丶 不	一 丿 丨
丿 丐	正
一 丑	㇆ 一 丨
一 丒	刃
一 且	月
一 丕	不
一 世	廿 丨
凵 丗	十
一 丘	厂 丅
冂 丙	一 人
一 丞	氶
去 丢	丿
一 丠	北
冂 両	一 山
开 并	丷
丨 丫	丶 丶
丨 丬	冫
丨 中	口
丨 丮	乁 二
彡 丯	丨
丨 丰	三
口 串	中
丿 丳	串
干 丵	业 丷
丿 丷	丶
九 丸	丶
一 丹	冂 丶
王 主	丶
丶 丼	井
丿 乂	乀
㇆ 乃	丿 ㇆
入 久	丿
人 乆	𠃊
七 乇	丿
厶 幺	𠃊
二 乍	丿 丅
亅 乎	丿 丷 一
之 乏	丿
乀 乑	丿 丨 丿 丿 丶
丿 乒	丘
丶 乓	丘
巾 乕	厂 二
北 乖	千
北 乘	禾
匕 乘	禾 丬
乚 乜	卩
乙 九	丿
乙 乞	丿 一
乚 也	卩 丨
乚 乢	山
乚 乣	幺
乚 乨	台
乙 乩	占
田 乪	乙
乙 乫	加
乙 乭	石
乙 乳	孚
乙 乴	折
乚 乵	辛
乙 乶	甫
乙 乷	沙
母 乸	也
乚 乹	十 日 十
十 干	一
乚 乿	爫 糸
曰 亀	龟
乞 亁	十 日 干
乚 乱	舌
乚 亃	粦
乚 亄	壹
亅 了	乛
亅 予	龴 乛
肀 亊	一 丷 亅
肀 事	一 口
一 二	一
丁 亍	一
亅 于	二
丂 亐	一
厶 云	二
彑 互	一
丌 亓	一
㇆ 五	二 丨
丨 井	二 丿
二 亖	二
二 亗	山
日 亘	二
二 些	此
业 亚	一
二 亝	厽
业 亚	一
一 亟	丂 口 又
一 亠	丶
匸 亡	丶
几 亢	亠
丌 亣	丶
父 交	亠
八 亦	亠 丿 亅
了 亨	亠 口
子 享	亠 口
小 京	亠 口
丁 亭	亠 口 冖
儿 亮	亠 口 冖
日 亯	亠 口
小 亰	亠 日
但 亱	亠
乇 亳	亠 口 冂
九 亴	亠 口 冂 土
旦 亶	亠 回
丿 亷	亠 兼
舋 亹	亠
乀 人	丿
丨 亻	丿
一 亼	人
人 亾	丨 一
十 什	亻
二 仁	亻
力 仂	亻
丁 仃	亻
人 仄	厂
卜 仆	亻
九 仇	亻
八 仈	亻
几 仉	亻
乛 今	人 丶
丨 介	人 丿
人 仌	人
乃 仍	亻
厶 仏	亻
十 仐	人
冫 仒	人
子 仔	亻
士 仕	亻
也 他	亻
丈 仗	亻
寸 付	亻
山 仙	亻
山 仚	人
乇 仛	亻
工 仜	亻
口 同	冂 一
刃 仞	亻
千 仟	亻
干 仠	亻
乞 仡	亻
勺 仢	亻
弋 代	亻
卩 令	人 一
小 仦	亻
人 仧	上
三 仨	亻
么 仫	亻
刄 仭	亻
反 仮	亻
少 仯	亻
卬 仰	亻
今 仱	亻
中 仲	亻
比 仳	亻
月 仴	亻
午 仵	亻
牛 件	亻
夭 仸	亻
丰 仹	亻
一 仺	人 匚
壬 任	亻
王 仼	亻
分 份	亻
互 仾	亻
方 仿	亻
公 伀	亻
止 企	人
巿 伂	亻
予 伃	亻
弔 伄	亻
屯 伅	亻
勿 伆	亻
殳 伇	亻
心 伈	亻
亢 伉	亻
尹 伊	亻
及 伋	亻
厄 伌	亻
五 伍	亻
支 伎	亻
犬 伏	亻
戈 伐	亻
木 休	亻
斤 伒	亻
不 伓	亻
冗 伔	亻
夫 伕	亻
友 伖	亻
火 伙	亻
卆 伜	亻
牙 伢	亻
匀 伨	人
文 伩	亻
玄 伭	亻
奴 伮	亻
白 伯	亻
古 估	亻
尒 伱	亻
尼 伲	亻
世 伳	亻
半 伴	人
四 伵	亻
令 伶	亻
由 伷	亻
申 伸	亻
且 伹	亻
司 伺	亻
平 伻	亻
以 似	亻
加 伽	亻
丕 伾	亻
只 伿	亻
一 佀	亻 尸 乛
台 佁	亻
正 佂	亻
田 佃	亻
甘 佄	亻
未 佅	亻
旦 但	亻
一 伫	亻 宀
巾 布	一 丿
去 佉	亻
皮 佊	亻
召 佋	亻
此 佌	亻
立 位	亻
氐 低	亻
主 住	亻
左 佐	亻
右 佑	亻
央 佒	亻
占 佔	亻
可 何	亻
必 佖	亻
它 佗	亻
示 佘	人
八 余	人 于
失 佚	亻
弗 佛	亻
乍 作	亻
句 佝	亻
女 佞	亻 二
冬 佟	亻
尔 你	亻
仚 佡	亻
巨 佢	亻
用 佣	亻
瓦 佤	亻
卡 佧	亻
帀 佩	亻 几
回 佪	亻
各 佫	亻
老 佬	亻
夅 佭	亻
合 佮	亻
羊 佯	亻
百 佰	亻
正 佱	亻 一
名 佲	亻
圭 佳	亻
耳 佴	亻
开 并	丷
吉 佶	亻
艮 佷	亻
舌 佸	亻
危 佹	亻
全 佺	亻
兆 佻	亻
交 佼	亻
次 佽	亻
月 佾	亻 八
吏 使	亻
刑 侀	亻
先 侁	亻
乇 侂	亻 广
川 侃	亻 口
至 侄	亻
亥 侅	亻
米 来	一
夷 侇	亻
多 侈	亻
夸 侉	亻
光 侊	亻
列 例	亻
云 侌	今
寺 侍	亻
米 侎	亻
朱 侏	亻
血 侐	亻
有 侑	亻
安 侒	亻
聿 侓	亻
牟 侔	亻
而 侕	亻
匕 仑	人
同 侗	亻
宅 侘	亻
式 侙	亻
旬 侚	亻
共 供	亻
舟 侜	亻
衣 依	亻
如 侞	亻
存 侟	亻
介 价	亻
再 侢	亻
忘 侫	亻
尽 侭	亻
每 侮	亻
矢 侯	亻 乛 一
君 侰	亻
呈 侱	亻
辰 侲	亻
坐 侳	亻
刂 侴	人 一 丑
又 侵	亻 彐 冖
吕 侣	亻
局 侷	亻
豆 侸	亻
廷 侹	亻
岑 侺	亻
兌 侻	亻
孛 侼	亻
男 侽	亻
孝 侾	亻
更 便	亻
妥 俀	亻
吴 俣	亻
小 系	丿 幺
足 促	亻
我 俄	亻
求 俅	亻
余 俆	亻
狂 俇	亻
告 俈	亻
吾 俉	亻
夋 俊	亻
邑 俋	亻
甫 俌	亻
良 俍	亻
且 俎	仌
肖 俏	亻
利 俐	亻
甬 俑	亻
完 俒	亻
见 伣	亻
宋 俕	亻
否 俖	亻
谷 俗	亻
孚 俘	亻
希 俙	亻
里 俚	亻
免 俛	亻
甹 俜	亻
呆 保	亻
刂 俞	人 一 月
矣 俟	亻
夹 侠	亻
言 信	亻
彡 俢	亻 夂
弟 俤	亻
车 伡	亻
彡 修	攸
府 俯	亻
和 俰	亻
具 俱	亻
効 俲	亻
非 俳	亻
表 俵	亻
叔 俶	亻
肥 俷	亻
奉 俸	亻
奄 俺	人
备 俻	亻
育 俼	亻
欣 俽	亻
卑 俾	亻
虎 俿	亻
长 伥	亻
知 倁	亻
并 併	亻
咎 倃	亻
肴 倄	亻
卒 倅	亻
两 俩	亻
宛 倇	亻
来 俫	亻
㔾 仓	人
忩 倊	亻
丨 个	人
官 倌	亻
咅 倍	亻
典 倎	亻
犬 倏	攸
火 倐	攸
门 们	亻
到 倒	亻
炎 倓	亻
屈 倔	亻
垂 倕	亻
羊 幸	土
朋 倗	亻
尚 倘	亻
矢 候	亻 丨 乛 一
奇 倚	亻
其 倛	亻
周 倜	亻
人 倝	十 日 十
京 倞	亻
昔 借	亻
隹 倠	人
昌 倡	亻
疌 倢	亻
放 倣	亻
直 値	亻
空 倥	亻
卷 倦	亻
宗 倧	亻
居 倨	亻
青 倩	亻
兒 倪	亻
仑 伦	亻
卓 倬	亻
委 倭	亻
果 倮	亻
松 倯	亻
夌 倰	亻
昆 倱	亻
事 倳	亻
奔 倴	亻
武 倵	亻
具 倶	亻
奈 倷	亻
采 倸	亻
佥 俭	亻
耶 倻	亻
直 值	亻
舍 倽	亻
英 偀	亻
爯 偁	亻
前 偂	亻
匽 偃	亻
耎 偄	亻
重 偅	亻
春 偆	亻
叚 假	亻
曷 偈	亻
韦 伟	亻
禹 偊	亻
屏 偋	亻
若 偌	亻
是 偍	亻
畏 偎	亻
扁 偏	亻
彦 偐	亻
易 偒	亻
屋 偓	亻
咢 偔	亻
皆 偕	亻
者 偖	亻
省 偗	亻
品 偘	亻
帝 偙	亻
故 做	亻
臿 偛	亻
亭 停	亻
背 偝	亻
枼 偞	亻
皇 偟	亻
要 偠	亻
甚 偡	亻
秋 偢	亻
音 偣	亻
酋 偤	亻
建 健	亻
疋 偦	亻 女
多 偧	亻 大
奓 偨	亻
畐 偪	亻
待 偫	亻
怱 偬	亻
面 偭	亻
咠 偮	亻
哀 偯	亻
契 偰	亻
盾 偱	亻
思 偲	亻
耑 偳	亻
则 侧	亻
贞 侦	亻
禺 偶	亻
俞 偷	亻
俞 偷	亻
备 偹	人 丨
昝 偺	亻
疌 偼	亻
为 伪	亻
鬼 傀	亻
叟 傁	亻
虒 傂	亻
素 傃	亻
眘 傄	亻
寸 傅	亻 甫
原 傆	亻
茸 傇	亻
栗 傈	亻
辱 傉	亻
冓 傋	亻
馬 傌	亻
旁 傍	人
真 傎	亻
唐 傏	亻
高 傐	亻
灬 杰	木
奚 傒	亻
扇 傓	亻
兼 傔	亻 丶 丶
隺 傕	亻
仓 伧	亻
畜 傗	亻
十 伞	人 丷
田 备	夂
攵 傚	人 交
容 傛	亻
羽 傝	亻 日
差 傞	亻
翁 傟	亻
竝 傡	亻
豕 家	宀
泰 傣	亻
累 傫	亻
崔 催	亻
用 佣	亻
曹 傮	亻
悤 傯	亻
崩 傰	亻
敖 傲	人
专 传	亻
区 伛	亻
责 债	亻
戚 傶	亻
力 伤	亻 丿 一
爽 傸	亻
竟 傹	亻
祭 傺	亻
夂 傻	亻 囟 儿
大 傼	亻 革
章 傽	亻
顷 倾	亻
焉 傿	亻
悉 僁	亻
娄 偻	亻
用 僃	人 艸 勹
票 僄	亻
又 仅	亻
翏 僇	亻
曼 僈	亻
一 佥	人 一 小
己 僊	亻 覀 大
攵 僌	亻 車
巽 僎	亻
象 像	亻
善 僐	亻
乔 侨	亻
窘 僒	亻
尊 僔	亻
卜 仆	亻
喜 僖	亻
敞 僘	亻
黃 僙	亻
尞 僚	亻
欺 僛	亻
登 僜	亻
孱 僝	亻
为 伪	亻
番 僠	亻
惠 僡	亻
舜 僢	亻
替 僣	亻
尧 侥	亻
就 僦	亻
曽 僧	亻
贲 偾	亻
矞 僪	亻
焦 僬	亻
朁 僭	亻
童 僮	亻
粦 僯	亻
人 僰	棘
隹 雇	户
粟 僳	亻
畺 僵	亻
葉 僷	亻
禁 僸	亻
介 价	亻
喿 僺	亻
辟 僻	亻
豐 僼	亻
愁 僽	亻
塞 僿	亻
义 仪	亻
雋 儁	亻
农 侬	亻
亶 儃	亻
乙 亿	亻
敬 儆	亻
睘 儇	亻
会 侩	亻
佥 俭	亻
楚 儊	亻
詹 儋	亻
敫 儌	亻
夂 傻	亻 囟 儿
载 傤	亻
宾 傧	亻
需 儒	亻
寿 俦	亻
齐 侪	亻
疑 儗	亻
冫 尽	尺
遣 儙	亻
舞 儛	亻
尝 偿	亻
巤 儠	亻
畾 儡	亻
暴 儤	亻
麃 儦	亻
尤 优	亻
豪 儫	亻
诸 储	亻
毚 儳	亻
襄 儴	亻
黑 儵	攸
巂 儶	亻
丽 俪	亻
难 傩	亻
党 傥	亻
严 俨	亻
纍 儽	亻
囊 儾	亻
儿 兀	一
儿 允	厶
旡 兂	厂 尢
儿 元	二
儿 兄	口
允 充	亠
丶 兆	冰 儿 丶
乂 凶	凵
儿 先	丿 土
兀 光	小
儿 兑	丷 口
儿 克	十 口
儿 兑	丷 口
儿 免	刀 口 丨
丶 兔	刀 口 丨 儿
儿 兏	厂 上
儿 児	旧
乚 儿	丿
旡 兓	旡
丶 兔	刀 口 丨 儿
儿 兕	凹
兊 兖	亠
兌 兗	亠
台 兘	元
千 兛	克
儿 兜	匚 白 ㇆ 一
分 兝	克
毛 兞	克
先 兟	先
儿 兠	丬 白 匕
克 兢	克
厘 兣	克
丿 入	乁
入 兦	丨 一
人 内	冂
王 全	人
人 两	一 冂 丨 人
刂 俞	人 一 月
乁 八	丿
厶 公	八
八 六	亠
丂 兮	八
八 共	十 丨 一
八 兲	王
八 兵	丘
八 其	甘 一
八 具	目 一
八 典	曲
八 兼	丷 一 聿 丨 丨
異 兾	丷
乙 艺	艸
異 冀	北
乙 冂	丨
二 冄	冂
员 圆	囗
冂 冇	一 丿
一 冉	冂 十
一 册	⺆ ⺆
口 冋	冂
一 再	一 冂 十
口 冏	冂 八
月 冐	曰
二 冑	由 冂
目 冒	冂 二
再 冓	井
吁 冔	冂 二
勉 冕	冂 二
乛 冖	丶
几 冗	冖
乚 冘	冖 丿
山 冚	冖
且 冝	冖
米 冞	冖
皂 冟	冖
寸 冠	冖 元
豕 冡	冖 一
豖 冢	冖
取 冣	冖
兔 冤	冖
大 冥	冖 日
攴 冦	冖 元
林 冧	冖
畐 冨	冖
舄 冩	冖
巾 幂	冖 日 大
丿 冫	丶
冫 冬	夂
冫 冭	大
工 冮	冫
水 冰	冫
互 冱	冫
牙 冴	冫
台 冶	冫
令 冷	冫
半 冸	冫
犮 冹	冫
民 冺	冫
先 冼	冫
列 冽	冫
合 冾	冫
聿 冿	冫
束 凁	冫
免 凂	冫
余 凃	冫
固 凅	冫
隹 准	冫
松 凇	冫
争 净	冫
青 凊	冫
周 凋	冫
夌 凌	冫
东 冻	冫
金 凎	冫
垔 凐	冰
栗 凓	冫
冥 凕	冫
崔 凗	冫
斯 凘	冫
禁 凚	冫
禀 凛	冫
疑 凝	冫
熙 凞	冫
乙 几	丿
丶 凡	几
几 凢	丶
几 凣	丶
几 凥	尸
卜 处	夂
巾 凧	几
云 凨	几
日 凬	几 一
百 凮	几
皇 凰	几
几 凯	岂
兼 凲	几
几 凳	登
丨 凵	丨 一
乂 凶	凵
土 凷	凵
凵 出	山
水 凼	凵
氶 函	凵
亟 凾	凵
丿 刀	㇆
亅 刂	丨
丶 刃	刀
乀 刄	刀
八 刅	刀
刀 分	八
刀 切	七
刂 刈	乂
刂 刉	乞
刂 刊	干
刂 刋	千
刂 刌	寸
彐 刍	刀
刂 刎	勿
刂 刏	气
刂 刐	丹
刂 刑	开
刂 划	戈
刂 刓	元
刂 刔	夬
刀 刕	刀 刀
刂 刖	月
刂 列	歹
刂 刜	弗
刀 初	衤
刂 刞	且
刂 刟	召
刂 刡	民
刂 刢	令
刂 刣	台
刂 判	半
刂 别	另
力 劫	去
力 劫	去
刂 刨	包
刂 利	禾
刂 删	册
刂 刮	舌
刂 刯	亘
刂 到	至
刅 刱	井
刂 刲	圭
刂 刳	夸
刂 剁	朵
刂 刵	耳
刂 制	丿 二 巾
刂 刷	尸 巾
刀 券	𠔉
刂 刺	朿
刂 刻	亥
力 劫	去
刂 剁	朵
刂 剃	弟
刂 刭	圣
刂 剅	豆
刂 剆	艮
刂 则	贝
刂 剈	肙
刂 剉	坐
刂 削	肖
儿 克	十 口
刂 剌	束
刂 前	丷 一 月
刂 刹	杀
刃 剏	并
刂 剒	昔
刀 剓	禾 勹 丿
刂 剔	易
刂 剕	非
刂 剖	咅
刂 刬	戋
刂 剘	其
刅 剙	并
刂 剚	事
刂 刚	冈
刂 剜	宛
刂 剥	录
刂 剞	奇
刂 剟	叕
刂 剠	京
刂 剡	炎
刂 剢	豖
刂 剑	佥
刂 剂	齐
刂 剦	奄
刂 剨	砉
刂 剩	乘
刀 剪	前
刂 剫	度
刂 剬	耑
刂 剭	屋
刂 剐	呙
刂 副	畐
刂 剩	乘
刂 剑	佥
刂 割	害
刂 剳	荅
刂 剀	岂
刂 创	仓
刂 剶	彖
刂 剹	翏
刀 剺	未 攵 厂
刂 剻	崩
刂 剽	票
刂 剿	巢
刂 劀	矞
刂 劁	焦
刂 劂	厥
刂 划	戈
刂 劄	答
刂 劅	蜀
刂 劆	廉
刂 剧	居
刀 劈	辟
刂 刘	文
刂 刽	会
刂 劋	喿
刂 刿	岁
刂 剑	佥
刂 剑	佥
刂 劐	蒦
刂 剂	齐
刂 剑	佥
刂 劓	鼻
刂 剑	佥
刂 劖	毚
刂 劘	靡
刂 劙	蠡
㇆ 力	丿
乚 劜	力
力 功	工
口 加	力
力 劣	少
力 劤	斤
力 劥	亢
力 劦	力 力
力 劧	手
力 助	且
力 努	奴
力 劫	去
力 劬	句
力 劭	召
力 劮	失
力 劯	石
力 劰	白
力 劳	艸 冖
力 劵	𠔉
力 劶	后
力 劷	羊
力 劸	圭
力 効	交
力 劺	牟
力 劻	匡
力 劼	吉
力 劽	列
力 劾	亥
力 勀	克
力 劲	圣
力 勂	告
力 勃	孛
力 勄	每
力 勅	束
力 勆	良
力 勇	甬
力 勈	甬
力 勉	免
力 勊	克
力 勌	卷
力 勍	京
力 勎	坴
力 勏	咅
力 勐	孟
力 勒	革
力 勓	皆
力 勔	面
力 动	云
力 勖	冒
助 勗	日
力 勘	甚
力 务	夂
力 勋	员
力 勜	翁
生 胜	月
力 劳	艹 冖
力 募	莫
力 勠	翏
力 勡	票
勢 势	执 力
力 勤	堇
力 勥	强
力 勦	巢
力 劝	又
力 勨	象
力 勚	贳
力 勫	番
力 勬	絭
力 勭	童
力 勮	豦
力 勯	亶
思 勰	劦
力 劢	万
灬 勲	動
力 勳	熏
力 励	厉
力 勶	徹
力 勷	襄
力 劝	又
㇆ 勹	丿
丶 勺	勹
冫 匀	勹
九 勼	勹
人 勽	勹
厶 勾	勹
丿 勿	勹 丿
亾 匃	勹
亡 匄	勹
己 包	勹
丶 匆	勿
凶 匈	勹
平 匉	勹
米 匊	勹
缶 匋	勹
合 匌	勹
甫 匍	勹
奄 匎	勹
包 匏	夸
畐 匐	勹
躬 匑	勹
荅 匒	勹
殳 匓	勹 艮
吕 匔	勹 身
丿 匕	乚
匕 化	亻
匕 北	丬
匕 匙	是
久 匛	匚
也 匜	匚
巾 匝	匚
工 匞	匚
亢 匟	匚
斤 匠	匚
王 匡	匚
勿 匢	匚
甲 匣	匚
玉 匤	匚
弁 匥	匚
夾 匧	匚
山 匩	匡
非 匪	匚
曶 匫	匚
俞 匬	匚
轨 匦	匚
匚 汇	氵
贵 匮	匚
品 匲	匚 大
算 匴	匚
瞿 匷	匚
儿 匹	匚
合 匼	匸
妟 匽	匸
扁 匾	匚
若 匿	匚
乂 区	匚
丨 十	一
十 卂	乁
十 千	丿
丨 卄	一 丨
一 卅	川
十 卆	九
丿 升	丿 十
干 午	丿
廾 卉	十
十 半	八 一
廿 卋	十
一 卌	川 丨
十 卑	丶 田 丿
十 卒	亠 人
十 卓	卜 日
办 协	十
二 南	十 冂 丫
十 単	小 日
十 卙	甚
寸 博	十 甫
丶 卜	丨
一 卝	一 丨 丨
下 卞	丶
卜 卟	口
口 占	卜
下 卡	上
囙 卣	卜
囪 卥	卜
卜 卦	圭
㇆ 卩	丨
丶 卪	卩
卩 卬	匚
卩 卭	工
卩 卮	厂 一
卩 卯	匸 丿
卩 印	匸 一
卩 危	刀 厂
卩 卲	召
卩 即	艮
卪 卵	匸 丿 丶
卩 卶	多
㔾 卷	𠔉
卩 卸	午 止
卩 卹	血
㔾 卺	丞
卩 却	去
危 卼	兀
卩 即	艮
卩 卾	咢
即 卿	匸 丿
卩 厀	桼
厂 厃	刀
㔾 厄	厂
乇 厇	厂
干 厈	厂
牙 厊	厂
氐 厎	厂
乍 厏	厂
缶 厒	厂
圭 厓	厂
至 厔	厂
尨 厖	厂
辛 厗	厂
车 厍	厂
子 厚	厂 日
丁 厅	厂
垂 厜	厂
昔 厝	厂
非 厞	厂
泉 原	厂
泉 厡	厂
秝 厤	厂
欮 厥	厂
真 厧	厂
堇 厪	厂
敖 厫	厂
晷 厬	厂
犬 厌	厂
丶 厯	厂 林 乚 丶
敞 厰	厂
万 厉	厂
丿 严	亚
甲 厣	厂 犬
原 厵	原 原
丶 厶	𠃊
厶 厷	一 丿
厶 厸	厶
厶 厹	九
厶 厺	大
厶 去	土
厶 厽	厶 厶
去 厾	乁
厶 叀	一 由
彡 参	厶 大
三 叁	厶 大
丶 叅	厽 人 小
丶 叉	又
乀 及	乃
又 友	一 丿
又 反	厂
又 収	丩
支 叏	乛
友 叐	丿
又 叒	又 又
口 叓	支
又 叔	尗
又 叕	又 又 又
又 取	耳
又 受	爫 冖
又 叚	尸 二
反 叛	半
又 叜	灾
及 叝	去
又 叞	尸 示
又 叟	臼 丨
又 叡	睿
一 丛	从
一 口	冂
口 古	十
口 句	勹
力 另	口
刀 叧	口
刀 叨	口
卩 叩	口
八 只	口
丩 叫	口
口 召	刀
八 叭	口
丁 叮	口
口 可	丁
口 台	厶
匕 叱	口
乂 史	口
口 右	一 丿
口 叴	九
口 叵	匚
口 司	㇆ 一
入 叺	口
力 叻	口
刁 叼	口
工 叿	口
千 吀	口
于 吁	口
口 吂	亡
乞 吃	口
口 各	夂
口 吅	口
幺 吆	口
子 吇	口
口 合	人 一
口 吉	士
寸 吋	口
口 同	冂 一
口 名	夕
口 后	厂 一
乀 吏	一 口 丿
土 吐	口
口 向	丶 冂
吒 咤	口 宅
下 吓	口
也 吔	口
丫 吖	口
午 吘	口
火 吙	口
尹 吚	口
口 君	尹
丑 吜	口
口 吝	文
口 吞	天
今 吟	口
犬 吠	口
比 吡	口
口 吢	心
心 吣	口
介 吤	口
不 吥	口
口 否	不
巴 吧	口
分 吩	口
化 吪	口
口 含	今
亢 吭	口
允 吮	口
厷 吰	口
支 吱	口
引 吲	口
天 吴	口
少 吵	口
内 呐	口
夬 吷	口
及 吸	口
欠 吹	口
殳 吺	口
勿 吻	口
孔 吼	口
牛 吽	口
口 吾	五
口 吿	牛
牙 呀	口
勻 呁	口
口 吕	口
厄 呃	口
古 呄	乃
文 呅	口
木 呆	口
口 呇	水
王 呈	口
天 吴	口
口 告	牛
夫 呋	口
斗 呌	口
云 呍	口
尺 呎	口
升 呏	口
口 吞	天
太 呔	口
戹 呝	口
司 呞	口
玄 呟	口
本 呠	口
民 呡	口
尼 呢	口
令 呤	口
冉 呥	口
幼 呦	口
氐 呧	口
口 周	冂 土
示 呩	口
兄 呪	口
占 呫	口
四 呬	口
世 呭	口
只 呮	口
平 呯	口
口 呰	此
瓜 呱	口
此 呲	口
未 味	口
句 呴	口
可 呵	口
奴 呶	口
甲 呷	口
一 呸	口 不
失 呹	口
号 呺	口
申 呻	口
乎 呼	口
叩 命	人 一
旦 呾	口
去 呿	口
且 咀	口
匝 咂	口
他 咃	口
出 咄	口
口 咅	立
包 咆	口
必 咇	口
弗 咈	口
央 咉	口
禾 咊	口
乍 咋	口
口 和	禾
台 咍	口
口 咎	夂 人
付 咐	口
打 咑	口
几 咒	口 口
瓦 咓	口
卡 咔	口
古 咕	口
加 咖	口
左 咗	口
布 咘	口
冬 咚	口
开 咞	口
百 咟	口
耳 咠	口
耳 咡	口
亏 咢	口 口
光 咣	口
宅 咤	口
至 咥	口
夷 咦	口
列 咧	口
口 咨	次
羊 咩	口
米 咪	口
只 咫	尺
交 咬	口
吉 咭	口
朱 咮	口
各 咯	口
旬 咰	口
自 咱	口
关 咲	口
亥 咳	口
灰 咴	口
夸 咵	口
舌 咶	口
兆 咷	口
口 咸	戊 一
安 咹	口
亘 咺	口
休 咻	口
内 呙	口
因 咽	口
老 咾	口
伊 咿	口
口 哀	衣
口 品	口 口
西 哂	口
同 哃	口
共 哄	口
匈 哅	口
多 哆	口
土 哇	口 土
合 哈	口
口 哉	土 戈
有 哊	口
地 哋	口
氏 哌	口 厂
向 响	口
艾 哎	口
艮 哏	口
匡 哐	口
朵 哚	口
牟 哞	口
告 哠	口
贝 员	口
弄 哢	口
豆 哣	口
尨 哤	口
可 哥	可
我 哦	口
赤 哧	口
肖 哨	口
里 哩	口
那 哪	口
足 哫	口
何 哬	口
犬 哭	口 口
孝 哮	口
牢 哰	口
孛 哱	口
口 哲	折
折 哳	口
良 哴	口
別 哵	口
羊 哶	口
寽 哷	口
妥 哸	口
孚 哹	口
甫 哺	口
旱 哻	口
享 哼	口
更 哽	口
兑 哾	口
可 哿	加
秀 唀	口
言 唁	口
谷 唂	口
角 唃	口
贝 呗	口
含 唅	口
夋 唆	口
辰 唇	口
邑 唈	口
矣 唉	口
余 唋	口
延 唌	口
完 唍	口
利 唎	口
希 唏	口
口 唐	广 聿
坐 唑	口
酉 唒	口
吾 唔	口
早 唕	口
亚 哑	口
走 唗	口
口 唘	石 又
狄 唙	口
又 唚	口 彐 冖
抖 唞	口
皂 唣	口
冷 唥	口
沙 唦	口
即 唧	口
阻 唨	口
委 唩	口
奉 唪	口
金 唫	口
虎 唬	口
其 唭	口
口 售	隹
隹 唯	口
刷 唰	口
昌 唱	口
兒 唲	口
戻 唳	口
羌 唴	口
奄 唵	口
昔 唶	口
育 唷	口
心 念	今
於 唹	口
典 唺	口
妾 唼	口
析 唽	口
垂 唾	口
忽 唿	口
厓 啀	口
周 啁	口
乳 啂	口
肯 啃	口
豖 啄	口
卓 啅	口
冏 商	亠 丷
古 啇	亠 丷 冂
幸 啈	口
林 啉	口
阿 啊	口
采 啋	口
空 啌	口
享 啍	口
吾 啎	午
口 问	门
卒 啐	口
疌 啑	口
屈 啒	口
口 启	户
口 啔	户 戈
匋 啕	口
炎 啖	口
陷 啗	口
宛 啘	口
口 啙	此 口
回 啚	口 亠
妻 啛	口
叕 啜	口
和 啝	口
亚 哑	口
口 启	户
口 啠	斤 斤
非 啡	口
两 唡	口
卸 啣	口
卑 啤	口
舍 啥	口
拉 啦	口
青 啨	口
卦 啩	口
拍 啪	口
者 啫	口
岩 啱	口
的 啲	口
卷 啳	口
波 啵	口
定 啶	口
郎 啷	口
口 啻	帝
帝 啼	口
弇 啽	口
秋 啾	口
甚 啿	口
客 喀	口
禺 喁	口
畏 喂	口
南 喃	口
口 善	羊 丷 一
昱 喅	口
口 哲	折
剌 喇	口
皆 喈	口
侯 喉	口
咸 喊	口
木 喋	口 世
州 喌	口 口
柴 喍	口
呙 㖞	口
若 喏	口
郁 喐	口
音 喑	口
昝 喒	口
要 喓	口
屋 喔	口
面 喕	口
枯 喖	口
而 喘	口 山
彖 喙	口
奂 唤	口
爰 喛	口
口 喜	士 口 丷 一
曷 喝	口
即 唧	口
胃 喟	口
重 喠	口
臿 喢	口
灬 喣	呴
皇 喤	口
度 喥	口
山 喦	品
宣 喧	口
亮 喨	口
俞 喩	口
契 喫	口
丨 乔	夭 丿
彦 喭	口
一 单	丷 甲
奔 喯	口
食 喰	口
厘 喱	口
喲 哟	口 约
查 喳	口
威 喴	口
苗 喵	口
吕 营	艸 冖
奎 喹	口
俞 喻	口
急 喼	口
木 喿	口 口 口
殳 嗀	士 冖 一 口
虒 嗁	口
高 嗃	口
夏 嗄	口
臭 嗅	口
仓 呛	口
回 啬	土 丷
邕 嗈	口
素 嗉	口
贡 唝	口
脅 嗋	口
益 嗌	口
朔 嗍	口
马 吗	口
茶 嗏	口
害 嗐	口
皿 嗑	口 去
荅 嗒	口
桑 嗓	口
真 嗔	口
辱 嗕	口
叟 嗖	口
骨 嗗	口
奚 嗘	口
旁 嗙	口
乌 呜	口
兼 嗛	口
日 嗜	口 老
鬲 嗝	口
兹 嗞	口
差 嗟	口
各 嗠	孚
翁 嗡	口
昷 嗢	口
司 嗣	口 冊
蚩 嗤	口
皋 嗥	口
索 嗦	口
海 嗨	口
贝 唢	口 小
秦 嗪	口
荷 嗬	口
晒 嗮	口
恩 嗯	口
拿 嗱	口
爹 嗲	口
通 嗵	口
毕 哔	口
敖 嗷	口
口 嗸	敖
崔 嗺	口
庶 嗻	口
莫 嗼	口
欠 嗽	口 束
族 嗾	口
啇 嘀	口
戚 嘁	口
口 嘂	口 口 丩 口
庸 嘃	口
既 嘅	口
又 叹	口
曹 嘈	口
加 嘉	士 口 丷 一
崖 嘊	口
教 嘋	口
票 嘌	口
娄 喽	口
戛 嘎	口
叚 嘏	古
翏 嘐	口
虖 嘑	口
彗 嘒	口
国 啯	口
区 呕	口
焉 嘕	口
责 啧	口
云 尝	小 冖
婆 嘙	口
得 嘚	口
麻 嘛	口
麦 唛	口
斛 嘝	口
勒 嘞	口
都 嘟	口
戈 嘠	口 百 冖
堂 嘡	口
野 嘢	口
朋 嘣	口
徙 嘥	口
要 嘦	只
密 嘧	口
肃 啸	口
华 哗	口
然 嘫	口
最 嘬	口
彭 嘭	口
劳 唠	口
肃 啸	口
几 叽	口
朝 嘲	口
觜 嘴	口
尧 哓	口
斯 嘶	口
臯 嘷	口
无 呒	口
尞 嘹	口
喜 嘻	口
口 嘼	口 口 田 一
单 啴	口
覃 嘾	口
黑 嘿	口
巽 噀	口
心 恶	亚
尊 噂	口
番 噃	口
潔 噄	口
朁 噆	口
童 噇	口
就 噈	口
敢 噉	口
矞 噊	口
敦 噋	口
曾 噌	口
焦 噍	口
壹 噎	口
翕 噏	口
口 噐	口 口 工 口
皐 噑	口
粦 噒	口
虚 嘘	口
登 噔	口
琴 噖	口
菐 噗	口
厥 噘	口
禽 噙	口
齿 啮	口
丝 咝	口
口 噟	广 人 隹
达 哒	口
詹 噡	口
奥 噢	口
蜀 噣	口
禁 噤	口
农 哝	口
岁 哕	口
口 器	口 口 大 口
丨 噩	一 口 口 一 口 口 一
木 噪	口 品
意 噫	口
筮 噬	口
敫 噭	口
睘 噮	口
爱 嗳	口
雍 噰	口
豦 噱	口
会 哙	口
虞 噳	口
贲 喷	口
口 噵	道
葛 噶	口
歆 噷	口
屯 吨	口
彐 当	小
塞 噻	口
辟 噼	口
丕 噽	喜
窨 噾	口
翠 噿	口
宁 咛	口
翟 嚁	口
遝 嚃	口
蒦 嚄	口
需 嚅	口
蒿 嚆	口
下 吓	口
鼻 嚊	口
齐 哜	口
豪 嚎	口
疐 嚏	口
云 尝	小 冖
察 嚓	口
疐 嚏	口
鲁 噜	口
慧 嚖	口
暴 嚗	口
憂 嚘	口
齿 啮	口
口 嚚	口 口 臣 口
墨 嚜	口
吉 嚞	吉 吉
黎 嚟	口
 嚢	十 口 冖 八 井 一
摩 嚤	口
因 咽	口
历 呖	口
龙 咙	口
否 嚭	喜
口 向	丶 冂
霍 嚯	口
磨 嚰	口
单 亸	享
告 喾	小 冖
丿 严	亚
毚 嚵	口
婴 嘤	口
襄 嚷	口
罅 嚹	口
遂 嚺	口 网
爵 嚼	口
雚 嚾	口
转 啭	口
聂 嗫	口
口 嚣	口 口 页 口
雜 囃	口
展 冁	单
艺 呓	口
罗 啰	口
 囊	一 口 丨 冂 口 口 井 一
办 苏	艸
口 囍	士 口 丷 一 口 士 口 丷 一
喜 囏	革 大
属 嘱	口
齿 啮	口
囊 囔	口
一 囗	丨 乛
口 回	囗
人 囚	囗
儿 四	囗
厶 囜	囗
子 囝	囗
口 回	囗
乂 囟	丶 囗
大 因	囗
女 囡	囗
寸 団	囗
屯 囤	囗
亢 囥	囗
水 囦	囗
冂 囧	囗 儿
不 囨	囗
云 囩	囗
丶 囪	丶 囗 丿 丿
勿 囫	囗
口 回	囗
化 囮	囗
王 囯	囗
木 困	囗
夕 囱	丶 囗
韦 围	囗
冬 图	囗
土 囶	囗 八
禾 囷	囗
正 囸	囗
令 囹	囗
古 固	囗
民 囻	囗
台 囼	囗
有 囿	囗
方 圀	囗 儿
言 圁	囗
豕 圂	囗
甫 圃	囗
吾 圄	囗
干 圅	龴 囗 丷
仑 囵	囗
卷 圈	囗
幸 圉	囗
青 圊	囗
玉 国	囗
耑 圌	囗
韦 围	囗
卷 圈	囗
方 圐	囗 网
尃 圑	囗
元 园	囗
员 圆	囗
盍 圔	囗
冬 图	囗
面 圗	囗 厶
才 团	囗
面 圙	囗 八
睘 圜	囗
一 土	十
乚 圠	土
丶 圡	土
丁 圢	土
卜 圤	土
儿 圥	土
圡 压	厂
土 在	一 亻
于 圩	土
乞 圪	土
乇 圫	土
亏 圬	土
土 圭	土
己 圮	土
巳 圯	土
也 地	土
土 圱	千
千 圲	土
川 圳	土
勺 圴	土
上 圵	土
土 圶	大
斤 圻	土
土 圼	日
勿 圽	土
及 圾	土
介 圿	土
止 址	土
氏 坁	土
反 坂	土
元 坃	土
殳 坄	土
今 坅	土
攵 坆	土
匀 均	土
冗 坈	土
屯 坉	土
方 坊	土
分 坋	土
分 坌	土
丹 坍	土
欠 坎	土
土 坐	人 人
亢 坑	土
土 坒	比
土 坓	井
水 坔	土
土 坕	爪
元 坖	土
互 坘	土
土 坙	一 巛
皮 坡	土
半 坢	土
土 坣	丷 宀
申 坤	土
且 坥	土
旦 坦	土
石 坧	土
它 坨	土
甘 坩	土
平 坪	土
占 坫	土
瓜 坬	土
尼 坭	土
台 坮	土
丕 坯	土
冋 坰	土
央 坱	土
弗 坲	土
幼 坳	土
土 坴	土 八
丘 坵	土
母 坶	土
可 坷	土
句 坸	土
穴 坹	土
犮 坺	土
氐 坻	土
斥 坼	土
令 坽	土
宁 坾	土
付 坿	土
乎 垀	土
矢 垁	土
丨 垂	丿 二 土 丨
立 垃	土
凹 垇	土
包 垉	土
土 型	刑
同 垌	土
自 垍	土
各 垎	土
聿 垏	土
土 垐	次
多 垑	土
亥 垓	土
土 垔	覀
土 垕	后
一 垖	土 户 乛
兆 垗	土
伏 垘	土
光 垙	土
土 垚	土 土
朵 垛	土
朵 垛	土
危 垝	土
宅 垞	土
羊 垟	土
艮 垠	土
土 垡	伐
后 垢	土
亘 垣	土
至 垤	土
合 垥	土
向 垧	土
守 垨	土
共 垬	土
夸 垮	土
安 垵	土
辛 垶	土
完 垸	土
邦 垹	土
孚 垺	土
贝 坝	土
土 垼	役
土 垽	沂
旱 垾	土
序 垿	土
土 埀	乖
岑 埁	土
更 埂	土
矣 埃	土
夆 埄	土
土 埅	防
角 埆	土
甬 埇	土
夋 埈	土
土 埊	山 水
里 埋	土
良 埌	土
肙 埍	土
成 城	土
延 埏	土
又 埐	土 彐 冖
土 埑	折
寽 埒	土
寽 埓	土
甫 埔	土
呈 埕	土
步 埗	土
冏 埛	土
土 埜	林
念 埝	土
定 埞	土
或 域	土
阜 埠	土
亚 垭	土
卷 埢	土
卒 埣	土
卑 埤	土
青 埥	土
宛 埦	土
具 埧	土
空 埪	土
尚 埫	土
隶 埭	土
炎 埮	土
奄 埯	土
采 埰	土
叔 埱	土
奉 埲	土
臽 埳	土
直 埴	土
垂 埵	土
丸 埶	坴
丸 执	扌
易 埸	土
咅 培	土
土 基	其
享 埻	土
奇 埼	土
帚 埽	土
土 埾	取
土 埿	泥
屈 堀	土
果 堁	土
土 堂	尚
比 昆	日
兒 堄	土
土 坚	丨 丨 又
隹 堆	土
丰 堇	廿 口
育 堉	土
土 垩	亚
朋 堋	土
固 堌	土
兔 堍	土
夌 堎	土
厓 堐	土
岸 堓	土
凵 垴	土 亠 乂
突 堗	土
土 堘	土 𠔉
土 堙	土 西
畐 堛	土
柬 堜	土
呙 埚	土
枼 堞	土
彖 堟	土
侯 堠	土
土 堡	保
保 堢	土
禺 堣	土
是 堤	土
土 堥	敄
皆 堦	土
耎 堧	土
曷 堨	土
恆 堩	土
甚 堪	土
夂 堫	土 凶 八
俞 堬	土
皇 堭	土
咢 堮	土
匽 堰	土
又 报	扌 卩
土 堲	即
眉 堳	土
丿 场	土 弓 丿
者 堵	土
月 堶	土 左
音 堷	土
重 堹	土
界 堺	土
土 堻	津
土 堼	封
罡 堽	土
春 堾	土
咸 堿	土
巷 塂	土
荒 塃	土
方 塄	土 罒
段 塅	土
宣 塇	土
土 塈	既
脊 塉	土
夬 块	土
土 茔	艸 冖
羽 塌	土 曰
土 塍	月 丷 夫
容 塎	土
岂 垲	土
素 塐	土
土 塑	朔
时 埘	土
冥 塓	土
荅 塔	土
翁 塕	土
乘 塖	土
塗 涂	氵 余 土
唐 塘	土
高 塙	土
冢 塚	土
栗 塛	土
冡 塜	土
旁 塝	土
土 塞	宀 井 大
土 塟	艸 死
追 塠	土
真 填	土
乌 坞	土
土 塣	浧
员 埙	土
鬲 塥	土
益 塧	土
恭 塨	土
皿 盐	土 卜
舀 塪	土
真 填	土
原 塬	土
昷 塭	土
射 塮	土
留 塯	土
土 塱	朗
丿 场	土 弓 丿
逢 塳	土
朋 塴	土
土 尘	小
鹿 塶	土
土 堑	斩
土 塺	麻
莫 塻	土
爽 塽	土
土 塾	孰
犀 墀	土
曼 墁	土
票 墂	土
竟 境	土
戚 墄	土
土 墅	野
章 墇	土
勘 墈	土
庸 墉	土
土 垫	执
庶 墌	土
土 墍	旣
郭 墎	土
堇 墐	土
啇 墑	土
商 墒	土
土 墓	莫
崔 墔	土
焉 墕	土
畣 墖	土
曾 增	土
乾 墘	土
梁 墚	土
土 坠	队
曾 增	土
虚 墟	土
善 墡	土
童 墥	土
番 墦	土
土 墨	黑
敦 墩	土
土 墪	敦
尊 墫	土
土 墬	阝 彖
盛 墭	土
土 堕	陏
土 墯	惰
覃 墰	土
登 墱	土
文 坟	土
黄 墴	土
奧 墺	土
啬 墙	土
敫 墽	土
土 垦	艮
辟 壀	土
土 壁	辟
土 壂	殿
畺 壃	土
土 壄	楙
土 壅	雍
土 壆	臼 爻 冖
云 坛	土
豦 壉	土
不 坏	土
当 垱	土
一 壌	土 衣 八 井
熏 壎	土
土 壑	卜 冖 一 谷 又
蓋 壒	土
丶 压	厂 土
豪 壕	土
需 壖	土
土 垒	厶 厶 厶
广 圹	土
卢 垆	土
閻 壛	土
云 坛	土
不 坏	土
龙 垄	土
龙 垅	土
圣 壡	睿
历 坜	土
襄 壤	土
雚 壦	土
土 壨	田 田 田 田
贝 坝	土
一 士	十
士 壬	丿
士 壮	丬
匕 壱	士 冖
买 卖	十
一 壴	士 口 丷
士 壵	士 士
业 壶	士 冖
豆 壹	士 冖
业 壶	士 冖
胥 壻	土
亚 壸	士 冖
寸 寿	丰
巨 壾	壴
尊 壿	土
吋 夀	韦 口 一
固 夁	士 罒
乀 夂	丿 丿
丨 夅	夂 匸
丰 夆	夂
又 变	亦
夂 夋	厶 八
夂 夌	土 八
夂 夎	坐
夂 夏	一 自
夂 夐	刀 罓 目
夂 夒	一 自 止 已 八
夂 夓	夏
夂 夔	丷 一 止 自 卩
丶 夕	丿 丿
卜 外	夕
㔾 夗	夕
卩 夘	夕
歹 夙	几
夕 多	夕
夕 夛	彐
丶 夜	亠 亻 夕
生 夝	夕
多 够	句
吉 夡	多
夕 梦	木 木
夕 夣	亠 厶 罒 冖
寅 夤	夕
火 伙	亻
多 夥	果
多 夦	甚
一 大	人
大 夨	𠃊
大 天	一
丶 太	大
人 夫	二
大 夬	乛
大 夭	丿
大 央	冂
力 夯	大
丨 夰	大 丿
夫 失	丶
十 夲	大
二 夳	大
小 夵	大
大 夶	大
人 夷	一 弓
亏 夸	大
川 夼	大
云 夽	大
大 夹	一 丷
巴 夿	大
大 奀	不
氐 奃	大
电 奄	大
卯 奅	大
巨 奆	大
可 奇	大
示 奈	大
十 奉	龹 一
大 奊	丨 一 圭
大 奌	占
土 奎	大 土
夭 奏	龹
大 奂	刀 冂
大 契	丰 刀
亥 奒	大
多 奓	大
卉 奔	大
大 奕	亦
镸 套	大
大 奘	壯
电 奙	厶 大
大 奚	爫 幺
明 奛	大
大 奜	非
周 奝	大
隹 奞	大
朋 奟	大
大 奠	酋
夰 奡	一 自
者 奢	大
明 奣	天
面 奤	大
大 奦	務
大 奥	丶 冂 米
大 奖	丬 夕
区 奁	大
寸 夺	大
百 奭	大 百
田 奋	大
歲 奯	大
大 奰	罒 罒 罒
丿 女	𠃊 一
又 奴	女
丁 奵	女
乃 奶	女
千 奷	女
干 奸	女
也 她	女
久 奺	女
女 奻	女
乇 奼	女
子 好	女
山 奾	女
女 奿	丸
女 妀	己
勺 妁	女
口 如	女
己 妃	女
女 妄	亡
工 妅	女
冘 妉	女
壬 妊	女
夫 妋	女
井 妌	女
开 妍	女
介 妎	女
文 妏	女
公 妐	女
巴 妑	女
户 妒	女
支 妓	女
亢 妔	女
中 妕	女
夭 妖	女
今 妗	女
云 妘	女
少 妙	女
不 妚	女
夬 妜	女
女 妆	丬
丑 妞	女
女 妟	日
內 妠	女
斤 妡	女
分 妢	女
比 妣	女
予 妤	女
女 妥	爫
丰 妦	女
元 妧	女
方 妨	女
石 妬	女
犮 妭	女
尼 妮	女
由 妯	女
乍 妰	女
召 妱	女
旦 妲	女
尔 你	亻
女 妴	夗
主 妵	女
玄 妶	女
失 妷	女
可 妸	女
未 妹	女
末 妺	女
女 妻	一 肀
必 妼	女
申 妽	女
女 妾	立
女 妿	加
禾 姀	女
句 姁	女
乏 姂	女
正 姃	女
民 姄	女
半 姅	女
母 姆	女
女 姇	付
令 姈	女
市 姉	女
丿 姊	女 丿 ㇉ 丨
台 始	女
冉 姌	女
册 姗	女
央 姎	女
甘 姏	女
且 姐	女
古 姑	女
以 姒	女
生 姓	女
女 委	禾
女 姕	此
巨 姖	女
并 姘	女
任 姙	女
兆 姚	女
同 姛	女
女 姜	羊
朱 姝	女
吉 姞	女
亥 姟	女
向 姠	女
舌 姡	女
月 姢	女 厶
交 姣	女
后 姤	女
老 姥	女
干 奸	女
干 姧	女 女
夷 姨	女
年 姩	女
至 姪	女
臣 姫	女
丨 姬	女 匸 丨 口
女 姭	劦
亘 姮	女
光 姯	女
旬 姰	女
夸 姱	女
安 姲	女
名 姳	女
女 姴	列
帀 姵	女 几
合 姶	女
有 姷	女
幵 姸	女
宅 姹	女
先 姺	女
因 姻	女
多 姼	女
危 姽	女
全 姾	女
女 姿	次
戎 娀	女
女 威	戊 一
共 娂	女
土 娃	女 土
甹 娉	女
肖 娋	女
里 娌	女
成 娍	女
女 娎	折
尨 娏	女
女 娑	沙
每 娒	女
尾 娓	女
克 娔	女
束 娕	女
足 娖	女
廷 娗	女
良 娘	女
男 娚	女
吴 娱	女
那 娜	女
否 娝	女
妥 娞	女
月 娟	女 口
辰 娠	女
志 娡	女
含 娢	女
弟 娣	女
我 娥	女
兵 娦	女
兑 娧	女
旱 娨	女
免 娩	女
吾 娪	女
延 娫	女
武 娬	女
矣 娭	女
言 娮	女
吴 娱	女
似 娰	女
取 娵	女
女 娶	取
垂 娷	女
其 娸	女
弦 娹	女
叕 娺	女
昌 娼	女
录 娽	女
厓 娾	女
女 娿	阿
阿 婀	女
女 娄	米
帛 婂	女
宗 婃	女
咅 婄	女
匊 婅	女
女 婆	波
采 婇	女
夌 婈	女
宛 婉	女
表 婊	女
虎 婋	女
叔 婌	女
奇 婍	女
隹 婎	女
兔 婏	女
果 婐	女
委 婑	女
炎 婒	女
女 婓	非
疌 婕	女
忝 婖	女
兒 婗	女
卷 婘	女
争 婙	女
昏 婚	女
京 婛	女
定 婝	女
幸 婞	女
固 婟	女
官 婠	女
卑 婢	女
爿 婣	女 片 一
周 婤	女
卓 婥	女
彐 妇	女
青 婧	女
岸 婩	女
女 婪	木 木
昆 婫	女
壬 婬	女 爫
亚 娅	女
女 婯	丽
典 婰	女
女 婱	弦
亭 婷	女
要 婹	女
女 婺	敄
南 婻	女
若 婼	女
叚 婽	女
俞 婾	女
胥 婿	女
禺 媀	女
帝 媂	女
柔 媃	女
美 媄	女
甚 媅	女
耎 媆	女
亲 媇	女
屋 媉	女
前 媊	女
春 媋	女
苗 媌	女
者 媎	女
耑 媏	女
女 媐	巸
重 媑	女
某 媒	女
皇 媓	女
面 媔	女
弇 媕	女
英 媖	女
宣 媗	女
威 媙	女
眉 媚	女
爰 媛	女
女 媝	秋
是 媞	女
枼 媟	女
月 媠	女 左
柬 媡	女
冒 媢	女
染 媣	女
思 媤	女
扁 媥	女
胃 媦	女
呙 娲	女
酋 媨	女
胡 媩	女
俞 媮	女
为 妫	女
比 媲	女 囟
息 媳	女
袁 媴	女
女 媵	月 丷 夫
茸 媶	女
辱 媷	女
蚩 媸	女
留 媹	女
攴 媺	女 彳 山 一 儿
女 媻	般
昷 媪	女
马 妈	女
冓 媾	女
鬼 媿	女
秦 嫀	女
家 嫁	女
叟 嫂	女
真 嫃	女
原 嫄	女
差 嫅	女
容 嫆	女
冥 嫇	女
疾 嫉	女
素 嫊	女
弱 嫋	女
兼 嫌	女
舀 嫍	女
旁 嫎	女
郎 嫏	女
女 嫐	女 男
要 嫑	不
比 嫓	女 刀 内
悘 嫕	女
票 嫖	女
区 妪	女
累 嫘	女
旋 嫙	女
曼 嫚	女
女 嫛	殹
章 嫜	女
康 嫝	女
庸 嫞	女
匿 嫟	女
女 嫠	未 攵 厂
啇 嫡	女
焉 嫣	女
堇 嫤	女
常 嫦	女
大 嫨	女 革
敕 嫩	女
翏 嫪	女
莫 嫫	女
庶 嫬	女
虖 嫭	女
雩 嫮	女
女 嫯	敖
欶 嫰	女
女 嫳	敝
辜 嫴	女
无 妩	女
焦 嫶	女
隋 嫷	女
善 嫸	女
黃 嫹	女
闲 娴	女
闲 娴	女
墨 嫼	女
尞 嫽	女
粦 嫾	女
画 婳	女
为 妫	女
登 嬁	女
女 媭	须
華 嬅	女
翕 嬆	女
尧 娆	女
喜 嬉	女
女 嬊	廿 北 口
单 婵	女
乔 娇	女
攵 嬍	女 彳 山 一 王
生 嬎	女 免
番 嬏	女
意 嬑	女
敫 嬓	女
生 嬔	女 免
女 嬖	辟
亶 嬗	女
遂 嬘	女
啬 嫱	女
廉 嬚	女
睘 嬛	女
董 嬞	女
喿 嬠	女
爱 嫒	女
良 娘	女
麽 嬷	女
翟 嬥	女
慈 嬨	女
宾 嫔	女
需 嬬	女
女 婴	贝 贝
男 嬲	男 女
凡 嬴	亡 口 月 女
审 婶	女
慝 嬺	女
燕 嬿	女
霜 孀	女
女 孁	霝
簋 孂	女
良 娘	女
韱 孅	女
雚 孉	女
靡 孊	女
女 娈	亦
一 子	了
丿 孑	了
一 孒	了
乀 孓	了
乙 孔	子
子 孕	乃
子 孖	子
子 字	宀
子 存	一 亻
子 孚	爫
子 孛	十 冖
攵 孜	子
子 孝	耂
心 孞	子
皿 孟	子
子 孠	司
台 孡	子
包 孢	子
子 季	禾
瓜 孤	子
子 孥	奴
子 孨	子 子
亥 孩	子
小 孙	子
好 孬	不
宗 孮	子
丸 孰	享
子 孱	尸 子 子
日 孴	孨
孚 孵	卵
子 孳	兹
子 孷	未 攵 厂
子 学	小 冖
子 孹	辟
需 孺	子
子 孼	辥
子 孽	薛
子 孪	亦
冖 宀	丶
几 宂	宀
匕 它	宀
九 宄	宀
乇 宅	宀
弓 宆	宀
于 宇	宀
寸 守	宀
女 安	宀
犬 宊	宀
木 宋	宀
元 完	宀
六 宍	宀
夭 宎	宀
厷 宏	宀
彑 宐	宀
井 宑	宀
毛 宒	宀
必 宓	宀
主 宔	宀
石 宕	宀
弘 宖	宀
示 宗	宀
㠯 官	宀
由 宙	宀
疋 定	宀
夗 宛	宀
且 宜	宀
头 实	宀
各 客	宀
亘 宣	宀
至 室	宀
有 宥	宀
臣 宦	宀
兆 宨	宀
米 宩	宀
成 宬	宀
君 宭	宀
口 宫	宀 口
孝 宯	宀
辛 宰	宀
作 宱	宀
呆 宲	宀
口 害	宀 丰
妟 宴	宀
肖 宵	宀
豕 家	宀
釆 宷	宀
辰 宸	宀
谷 容	宀
川 宺	向 一
山 宻	宀 又 丷
女 宼	宀 元
百 宿	宀 亻
采 寀	宀
疌 寁	宀
叔 寂	宀
兔 寃	宀
奇 寄	宀
八 寅	宀 一 由
山 密	宓
攴 寇	宀 元
青 寈	宀
隹 寉	宀
大 寋	宀 井
畐 富	宀
皿 寍	宀 心
丙 寎	宀 爿
奐 寏	宀
未 寐	宀 爿
侵 寑	宀
冫 寒	宀 井 大
禺 寓	宀
是 寔	宀
丁 寕	宀 一 丶 罒
浸 寖	宀
冉 寗	宓
真 寘	宀
瓜 寙	宀 瓜
缶 寚	宀 王
见 宽	宀 艸
丁 宁	宀
莫 寞	宀
祭 察	宀
分 寡	宀 直
又 寝	宀 丬 彐 冖
言 寣	宀 爿
吾 寤	宀 爿
翏 寥	宀
头 实	宀
丁 宁	宀
木 寨	宀 井 大
申 审	宀
与 写	冖
见 宽	宀 艸
惠 寭	宀
尞 寮	宀
雋 寯	宀
睘 寰	宀
臬 寱	宀 爿
疑 寲	宀
玉 宝	宀
龙 宠	宀
玉 宝	宀
豐 寷	宀
丶 寸	一 亅
寸 寺	土
寸 寽	爫
寸 对	又
寸 尀	叵
寸 封	圭
龴 专	二 丨
寸 尃	甫
寸 射	身
寸 尅	克
寸 将	丬 夕
龴 专	二 丨
寸 尉	尸 示
寸 尊	酋
寸 寻	彐
寸 尌	壴
寸 对	又
寸 导	巳
亅 小	八
乀 尐	小
丿 少	小
小 尒	人
小 尓	丿 一
小 尕	乃
大 尖	小
小 尗	上
口 尚	小 冂
口 尚	小 冂
小 尛	小 小
小 尜	小 大
小 尞	昚
少 尟	是
少 尠	甚
乚 尢	一 丿
儿 尣	八
丶 尤	一 丿 乚
勺 尥	尢
勺 尦	尣
彡 尨	尤
王 尩	尣
王 尪	尢
王 尫	兀
介 尬	尢
朶 尮	尢
危 尯	尢
重 尰	尢
尤 就	京
兼 尲	尢
骨 尳	尢
监 尴	尢
监 尴	尢
丿 尸	㇆ 一
丿 尹	彐
乀 尺	尸
九 尻	尸
匕 尼	尸
毛 尾	尸
水 尿	尸
口 局	尸 ㇆
比 屁	尸
穴 屄	尸
古 居	尸
由 届	尸
田 屇	尸
出 屈	尸
至 屋	尸
吊 屌	尸
丿 尸	㇆ 一
米 屎	尸
并 屏	尸
支 屐	尸 彳
肖 屑	尸
辰 屒	尸
贝 屃	尸
尼 屔	丘
 展	尸 龷
辛 屖	尸
子 屘	尾
阿 屙	尸
雨 屚	尸
并 屏	尸
世 屉	尸
非 屝	尸
枼 屟	尸
者 屠	尸
娄 屡	尸
徙 屣	尸
云 层	尸
復 履	尸
枼 屧	尸 彳
娄 屦	尸 彳
尞 屪	尸
禹 属	尸
贝 屃	尸
丨 屮	凵
乚 屯	丿 凵
屮 屰	丷 一
丨 山	凵
山 屳	入
力 屴	山
厂 屵	山
工 屸	山
乞 屹	山
己 屺	山
刃 屻	山
兀 屼	山
干 屽	山
山 屾	山
月 岄	山
反 岅	山
夭 岆	山
卬 岇	山
牙 岈	山
勿 岉	山
山 岊	巴
及 岋	山
及 岌	山
开 岍	山
分 岎	山
元 岏	山
支 岐	山
今 岑	山
今 岒	山
斤 岓	山
山 岔	分
介 岕	山
山 岙	夭
巴 岜	山
乍 岝	山
乍 岞	山
央 岟	山
巨 岠	山
乂 冈	冂
可 岢	山
句 岣	山
穴 岤	山
皮 岥	山
立 岦	山
召 岧	山
且 岨	山
石 岩	山
弗 岪	山
由 岫	山
甲 岬	山
它 岮	山
丕 岯	山
幼 岰	山
山 岱	代
兄 岲	山
山 岳	丘
丘 岴	山
古 岵	山
白 岶	山
民 岷	山
厈 岸	山
召 岹	山
令 岺	山
氐 岻	山
田 峀	山
卯 峁	山
冬 峂	山
合 峆	山
合 峇	山
各 峈	山
各 峉	山
山 峊	户 乛 一
旬 峋	山
至 峌	山
聿 峍	山
艮 峎	山
而 峏	山
亥 峐	山
全 峑	山
同 峒	山
夷 峓	山
老 峔	山
日 峕	山 亠
安 峖	山
危 峗	山
亘 峘	山
寺 峙	山
圶 峚	山
列 峛	山
企 峜	山
同 峝	山
危 峞	山
有 峟	山
下 峠	山 上
列 峢	山
交 峧	山
我 峨	山
我 峨	山
谷 峪	山
邪 峫	山
甫 峬	山
肖 峭	山
君 峮	山
夆 峯	山
夆 峰	山
山 峱	丑
利 峲	山
攸 峳	山
见 岘	山
宏 峵	山
山 岛	勹 丶 勹
辛 峷	山
成 峸	山
山 峹	余
更 峺	山
夋 峻	山
告 峼	山
夹 峡	山
山 峾	沂
吾 峿	山
良 崀	山
坎 崁	山
角 崅	山
空 崆	山
宗 崇	山
山 崈	宗
沓 崉	山
居 崌	山
来 崃	山
奇 崎	山
昏 崏	山
昆 崐	山
比 昆	日
卒 崒	山
固 崓	山
隹 崔	山
厓 崕	山
厓 崖	山
冈 岗	山
匕 仑	人
夌 崚	山
屈 崛	山
垂 崜	山
青 崝	山
享 崞	山
金 崟	山
函 崡	山
争 峥	山
委 崣	山
肴 崤	山
卑 崥	山
奄 崦	山
松 崧	山
朋 崩	山
卒 崪	山
屈 崫	山
东 岽	山
固 崮	山
金 崯	山
皇 崲	山
俞 崳	山
威 崴	山
封 崶	山
酋 崷	山
帝 崹	山
施 崺	山
待 崻	山
是 崼	山
思 崽	山
要 崾	山
咢 崿	山
柱 嵀	山
甚 嵁	山
律 嵂	山
彦 嵃	山
美 嵄	山
咸 嵅	山
山 嵆	禾 尤
山 嵇	禾 尤
爰 嵈	山
亭 嵉	山
乘 嵊	山
眉 嵋	山
欠 嵌	山 甘
山 嵍	敄
禺 嵎	山
夂 嵏	山 凶 八
风 岚	山
曷 嵑	山
山 嵒	品
品 嵓	山
畏 嵔	山
夂 嵕	山 凶 八
查 嵖	山
小 嵗	山 戊 一
俞 嵛	山
山 嵞	余 山
隹 嵟	山
奚 嵠	山
翁 嵡	山
倉 嵢	山
唐 嵣	山
冚 嵤	火 火
桀 嵥	山
留 嵧	山
高 嵩	山
兹 嵫	山
鬼 嵬	山
旁 嵭	山
真 嵮	山
差 嵯	山
兼 嵰	山
容 嵱	山
臬 嵲	山
差 嵳	山
脊 嵴	山
強 嵹	山
翏 嵺	山
雩 嶀	山
娄 嵝	山
章 嶂	山
斩 崭	山
山 嶅	敖
曹 嶆	山
区 岖	山
唯 嶉	山
推 嶊	山
習 嶍	山
尉 嶎	山
配 嶏	山 厂
隆 嶐	山
象 嶑	山
曾 嶒	山
番 嶓	山
钦 嵚	山
焦 嶕	山
翕 嶖	山
劳 崂	山
粦 嶙	山
尞 嶚	山
尞 嶛	山
朁 嶜	山
登 嶝	山
山 嶞	隋
尊 嶟	山
乔 峤	山
厥 嶡	山
尧 峣	山
火 嶣	崔
厥 嶥	山
詹 嶦	山
丨 峄	山 又 二
山 峃	小 冖
辛 嶭	山 户 乛 一
佥 崄	山
戢 嶯	山
解 嶰	山
葛 嶱	山
乃 隽	隹
土 嶳	山 豕 土
罪 嶵	山
疑 嶷	山
荣 嵘	山
令 岭	山
截 嶻	山
与 屿	山
山 岳	丘
戈 巀	山 雀
冏 巂	山 隹
鞠 巈	山
毚 巉	山
归 岿	山
石 岩	山
魏 巍	山
夒 巎	山
雚 巏	山
昇 巐	山 高
山 峦	亦
顚 巓	山
巔 巅	山 顛
夔 巙	山
丨 川	丿 丨
丶 州	川 丶 丶
川 巟	亡
工 巠	一 巛
巛 巡	辶
果 巢	巛
果 巢	巛
乀 巤	巛 囗 乂 𠄌 丶 丶 𠄌 丶 丶
一 工	一 丨
工 左	一 丿
万 巧	工
一 巨	匸 ㇆
人 巫	工 人
工 差	羊 丿
巟 巯	圣
乚 己	㇆ 一
乚 已	㇆ 一
乚 巳	㇆ 一
丶 巴	巳
巴 巵	厂 一
巳 巶	召
己 巷	共
己 巹	丞
八 巺	巳 巳 一
㔾 卷	𠔉
共 巽	己 己
丨 巾	冂
巾 巿	一
巿 帀	一 巾
巾 市	亠
巾 布	一 丿
丁 帄	巾
凡 帆	巾
巾 帇	彐
分 帉	巾
巴 帊	巾
巾 帋	氏
巾 希	乂 一 丿
巾 帍	户
冘 帎	巾
巾 帑	奴
巾 帒	代
末 帓	巾
皮 帔	巾
白 帕	巾
占 帖	巾
犮 帗	巾
巾 帘	奴
失 帙	巾
巾 帚	彐 冖
巾 帛	白
巾 帝	亠 丷 冖
百 帞	巾
巾 帟	亦
巾 帠	臼
合 帢	巾
巾 帣	𠔉
巾 帤	如
巾 帅	丨 丿
兑 帨	巾
肖 帩	巾
辰 帪	巾
帀 师	丨 丿
吊 帬	尹
巾 席	广 廿
巾 帯	丗 冖
并 帡	巾
长 帐	巾
宛 帵	巾
巾 带	卅 冖
隹 帷	巾
巾 常	尚
妾 帹	巾
其 帺	巾
冒 帽	巾
者 帾	巾
侯 帿	巾
贞 帧	巾
韦 帏	巾
屋 幄	巾
畐 幅	巾
曷 幆	巾
巾 帮	邦
屏 幈	巾
巾 幋	般
晃 幌	巾
舀 幍	巾
冥 幎	巾
家 幏	巾
巾 幐	月 丷 夫
攵 幑	彳 山 帀
悤 幒	巾
曼 幔	巾
巾 幕	莫
票 幖	巾
国 帼	巾
责 帻	巾
莫 幙	巾
巾 幚	邦
章 幛	巾
景 幜	巾
菐 幞	巾
只 帜	巾
番 幡	巾
童 幢	巾
巾 币	一
巾 幦	辟
喿 幧	巾
詹 幨	巾
蒙 幪	巾
巾 帮	邦
寿 帱	巾
蔑 幭	巾
廚 幮	巾
丨 干	二
丷 平	干
丨 年	丿 一 二 丶
干 幵	千
羊 幸	土
十 干	一
㇆ 幻	幺
力 幼	幺
幺 幽	山 幺
乚 几	丿 一
匕 庀
丁 厅	厂
人 庂	广
丿 广	丶 一
么 庅	广
比 庇	广
今 庈	广
屯 庉	广
木 床	广
支 庋	广
牙 庌	广
斤 庍	广
介 庎	广
予 序	广
氐 底	广
包 庖	广
占 店	广
甲 庘	广
人 庚	广 肀
此 庛	广
付 府	广
冬 庝	广
羊 庠	广
衣 庡	广
至 庢	广
兆 庣	广
寺 庤	广
休 庥	广
又 度	广 廿
坐 座	广
孝 庨	广
余 庩	广
技 庪	广
车 库	广
尨 庬	广
廷 庭	广
酉 庮	广
甫 庯	广
并 庰	广
夌 庱	广
卑 庳	广
昔 庴	广
奄 庵	广
灬 庶	广 廿
隶 康	广
二 庸	广 聿 冂
尺 庹	广 廿
枀 庺	广
人 庻	广 廿 人
禺 庽	广
臾 庾	广
苗 庿	广
叜 廀	广
则 厕	厂
廂 厢	厂 相
发 废	广
既 厩	厂
盍 廅	广
鬼 廆	广
留 廇	广
夏 厦	厂
兼 廉	广
郎 廊	广
叟 廋	广
灬 廌	广 乛 一 丨 丨 ㇉
部 廍	广
顷 庼	广
殳 廏	广 白 匕
旡 廐	广 白 匕
堇 廑	广
敖 廒	广
郭 廓	广
翏 廖	广
鹿 廘	广
寸 厨	厂 豆
土 廛	广 里 儿
屠 廜	广
廝 厮	厂 斯
廟 庙	广 由
丿 厂	一
无 庑	广
发 废	广
丿 广	丶 一
辟 廦	广
解 廨	广
禀 廪	广
户 庐	广
丁 厅	厂
雝 廱	广
丁 厅	厂
巛 廵	廴
止 延	廴 丿
壬 廷	廴
由 廸	廴
白 廹	廴
聿 建	廴
回 廻	廴
㇆ 乃	丿 ㇆
回 廻	廴
丨 廾	一 丿
凵 廿	一
廾 弁	厶
廾 弄	王
廾 弅	分
廾 弆	去
廾 弇	合
廾 弈	亦
廾 弊	敝
丶 弋	一 乁
一 弌	弋
二 弍	弋
三 弎	弋
工 式	弋
二 弐	一 弋
弒 弑	杀 式
㇉ 弓	㇆ 一
巾 吊	口
丨 引	弓
一 弖	弓
丨 弗	弓 丿
厶 弘	弓
于 弙	弓
弔 弚	八
也 弛	弓
弓 弜	弓
巴 弝	弓
欠 弞	弓
丿 弟	丷 弓 丨
巨 弡	弓
又 弢	弓 屮
付 弣	弓
氐 弤	弓
玄 弦	弓
瓜 弧	弓
召 弨	弓
弓 弩	奴
臣 弫	弓
耳 弭	弓
弓 弮	𠔉
肖 弰	弓
冫 弱	弓 冫 弓
肙 弲	弓
圣 弪	弓
享 弴	弓
长 张	弓
京 弶	弓
虽 强	弓
朋 弸	弓
弓 弻	弓 丙 一
弓 弼	弓 百
枼 弽	弓
单 弹	弓
弓 弿	宀 井 大
殳 彀	士 冖 一 弓
矤 彂	业
刂 别	另
单 弹	弓
黃 彉	弓
畺 彊	弓
睘 彋	弓
尔 弥	弓
弓 弯	亦
矍 彏	弓
水 录	彐
豕 彖	彑
彐 彗	丰 丰
匕 彘	彑 匕 矢
匚 汇	氵
果 彚	彐 冖
廾 彛	彐 米 分
廾 彝	彑 米 糸
蒦 彟	寻
丿 彡	丿 丿
彡 形	开
彡 彣	丶 又
彡 彤	丹
彡 彦	亠 丷 厂
丿 彧	或 丿
彡 彩	采
彡 彪	虎
隹 雕	周
彡 彬	林
彡 彭	壴
彡 彮	容
彡 彯	票
彡 彰	章
彡 影	景
彡 彨	丽
亻 彳	丿
勺 彴	彳
也 彵	彳
及 彶	彳
方 仿	亻
公 彸	彳
殳 役	彳
王 彺	彳
皮 彼	彳
氐 彽	彳
令 彾	彳
弗 彿	彳
主 往	彳
正 征	彳
且 徂	彳
生 徃	彳
寺 待	彳
西 徆	彳
旬 徇	彳
艮 很	彳
羊 徉	彳
回 徊	彳
聿 律	彳
口 后	厂 一
圭 徍	彳
呈 徎	彳
步 徏	彳
余 徐	彳
圣 径	彳
走 徒	彳
人 从	人
宗 徖	彳
寸 得	彳 日 一
非 徘	彳
疋 徙	彳 止
奇 徛	彳
尚 徜	彳
直 徝	彳
人 从	人
周 徟	彳
来 徕	彳
卸 御	彳
疌 徢	彳
昔 徣	彳
建 徤	彳
是 徥	彳
叚 徦	彳
扁 徧	彳
皇 徨	彳
夂 复	丿 一 日
盾 循	彳
旁 徬	彳
攵 微	彳 山 兀
奚 徯	彳
正 徰	彳 正
票 徱	彳
犀 徲	彳
心 德	彳 十 罒 一
攵 徴	彳 山 王
正 征	彳
敝 徶	彳
心 德	彳 十 罒 一
童 徸	彳
切 彻	彳
敫 徼	彳
攵 徽	彳 山 糸
攵 徾	彳 山 一 言
襄 忀	彳
水 忁	彳 日 出 大
瞿 忂	彳
丶 心	丿 乚 丶
丿 必	心
力 忇	忄
心 忈	二
刀 忉	忄
丁 忊	忄
己 忋	忄
心 忌	己
心 忍	刃
心 忎	千
心 忐	上
心 忑	下
心 忒	弋
干 忓	忄
乞 忔	忄
大 忕	忄
寸 忖	忄
心 志	士
心 忘	亡
亡 忙	忄
也 忚	忄
凡 忛	忄
一 应	广 小
心 忝	天
心 忞	文
文 忟	忄
心 忠	中
中 忡	忄
心 忢	五
及 忣	忄
午 忤	忄
心 忥	气
介 忦	忄
元 忨	忄
心 忩	公
公 忪	忄
夬 快	忄
予 忬	忄
卞 忭	忄
支 忮	忄
氐 忯	忄
卆 忰	忄
冘 忱	忄
太 忲	忄
屯 忳	忄
今 忴	忄
心 念	今
云 忶	忄
凶 忷	忄
丑 忸	忄
王 忹	忄
欠 忺	忄
斤 忻	忄
亢 忼	忄
心 忽	勿
心 忿	分
巨 怇	忄
世 怈	忄
包 怉	忄
召 怊	忄
民 怋	忄
丕 怌	忄
乍 怍	忄
心 怎	乍
央 怏	忄
句 怐	忄
半 怑	忄
心 怒	奴
奴 怓	忄
正 怔	忄
白 怕	忄
布 怖	忄
占 怗	忄
心 怘	古
古 怙	忄
且 怚	忄
旦 怛	忄
心 思	田
由 怞	忄
氐 怟	忄
心 怠	台
台 怡	忄
失 怢	忄
心 怣	失
心 怤	付
心 急	刍
平 怦	忄
生 性	忄
心 怨	夕 卩
尼 怩	忄
圣 怪	忄
弗 怫	忄
四 怬	忄
必 怭	忄
幼 怮	忄
去 怯	忄
玄 怰	忄
心 怱	匆
丙 怲	忄
兄 怳	忄
戉 怴	忄
术 怵	忄
皮 怶	忄
心 怷	朮
心 怸	术
心 怹	他
多 恀	忄
心 恁	任
旬 恂	忄
寺 恃	忄
吉 恄	忄
老 恅	忄
亘 恒	忄
匡 恇	忄
牟 恈	忄
旨 恉	忄
劦 恊	忄
兆 恌	忄
光 恍	忄
至 恎	忄
心 恏	好
心 恐	工 凡
危 恑	忄
西 恓	忄
交 恔	忄
心 恕	女 口
夸 恗	忄
休 恘	忄
心 恙	羊
心 恚	圭
回 恛	忄
式 恜	忄
心 恝	丰 刀
夷 恞	忄
匈 恟	忄
在 恠	忄
厷 恡	忄 乂
灰 恢	忄
心 恣	次
血 恤	忄
止 耻	耳
向 恦	忄
心 恧	而
艮 恨	忄
心 恩	因
各 恪	忄
同 恫	忄
舌 恬	忄
丶 恭	共 小
全 恮	忄
心 息	自
合 恰	忄
兊 恱	忄
并 恲	忄
心 恴	亠 日
心 惠	叀
芒 恾	忄
甬 悀	忄
肙 悁	忄
坒 悂	忄
困 悃	忄
肖 悄	忄
兑 悦	忄
心 悆	余
余 悇	忄
戒 悈	忄
心 悉	釆
心 悊	折
吝 悋	忄
弟 悌	忄
旱 悍	忄
告 悎	忄
心 悐	狄
甫 悑	忄
邑 悒	忄
每 悔	忄
希 悕	忄
孛 悖	忄
免 悗	忄
心 悘	医
亨 悙	忄
束 悚	忄
夋 悛	忄
呈 悜	忄
里 悝	忄
吴 悮	忄
吾 悟	忄
心 悠	攸
心 悡	利
良 悢	忄
心 患	串
心 悤	囱
心 悥	言
利 悧	忄
心 您	你
凵 恼	忄 亠 乂
心 恶	亚
宗 悰	忄
非 悱	忄
心 悲	非
心 悳	直
卒 悴	忄
长 怅	忄
心 闷	门
戾 悷	忄
季 悸	忄
心 悹	官
官 悺	忄
幸 悻	忄
卓 悼	忄
妻 悽	忄
空 悾	忄
忝 悿	忄
心 惁	析
臽 惂	忄
昆 惃	忄
心 惄	叔
青 情	忄
周 惆	忄
享 惇	忄
果 惈	忄
心 惉	沾
宛 惋	忄
怨 惌	宀
金 惍	忄
心 惎	其
林 惏	忄
或 惐	忄
心 惑	或
心 惒	和
卷 惓	忄
炎 惔	忄
易 惕	忄
心 惖	易
念 惗	忄
罔 惘	忄
叕 惙	忄
忽 惚	忄
昏 惛	忄
昔 惜	忄
尚 惝	忄
欣 惞	忄
隹 惟	忄
心 惠	一 由 厶
心 恶	亚
心 惢	心 心
心 惣	物
弦 惤	忄
心 惥	臾
店 惦	忄
心 惪	直
月 惰	忄 左
凵 恼	忄 亠 乂
军 恽	忄
心 想	相
耑 惴	忄
枼 惵	忄
皇 惶	忄
心 惷	春
子 惸	忄 旬
心 惹	若
星 惺	忄
则 恻	忄
扁 惼	忄
昬 惽	忄
夂 惾	忄 凶 八
是 惿	忄
秋 愀	忄
心 愁	秋
心 愂	勃
宣 愃	忄
畏 愄	忄
革 愅	忄
心 愆	衍
心 愈	俞
俞 愉	忄
畐 愊	忄
爰 愋	忄
心 愍	敃
复 愎	忄
心 意	音
面 愐	忄
勇 愑	忄
曷 愒	忄
音 愔	忄
咢 愕	忄
甚 愖	忄
心 愗	敄
客 愘	忄
心 愙	客
心 愚	禺
友 爱	爫 冖
匧 惬	忄
匽 愝	忄
耎 愞	忄
心 感	咸
怱 愡	忄
思 愢	忄
方 愣	忄 罒
鬼 愧	忄
心 愨	士 冖 一 殳
素 愫	忄
心 愬	朔
耆 愭	忄
隻 愯	忄
晃 愰	忄
疾 愱	忄
骨 愲	忄
心 愳	目 目
仓 怆	忄
弱 愵	忄
脅 愶	忄
岂 恺	忄
容 愹	忄
草 愺	忄
真 慎	忄
尃 愽	忄
气 忾	忄
奚 慀	忄
心 慁	圂
心 恿	甬
翁 慃	忄
木 栗	西
蚤 慅	忄
舀 慆	忄
心 慇	殷
心 慈	茲
畜 慉	忄
兼 慊	忄 丶 丶
心 态	太
荒 慌	忄
昷 愠	忄
真 慎	忄
冥 慏	忄
曹 慒	忄
票 慓	忄
莫 慔	忄
丶 慕	莫 小
心 慗	敕
参 惨	忄
斩 惭	忄
崔 慛	忄
心 慜	敏
心 慝	匿
章 慞	忄
动 恸	忄
敖 慠	忄
爽 慡	忄
曼 慢	忄
贯 惯	忄
心 悫	壳
造 慥	忄
心 慦	救
心 慧	彗
既 慨	忄
区 怄	忄
心 怂	从
堇 慬	忄
心 虑	虍
心 慰	尉
坚 悭	忄
習 慴	忄
庸 慵	忄
大 庆	广
康 慷	忄
娄 㥪	忄
目 慻	忄 丷 夫
心 慼	戚
戚 慽	忄
欠 欲	谷
翏 憀	忄
悤 憁	忄
尤 忧	忄
心 憃	舂
心 憄	徝
心 憅	動
堂 憆	忄
心 憇	甜
彭 憉	忄
心 惫	备
心 憋	敝
曽 憎	忄
祭 憏	忄
令 怜	忄
几 凭	任
贵 愦	忄
惠 憓	忄
焦 憔	忄
登 憕	忄
心 慭	来 犬
喜 憘	忄
心 憙	喜
单 惮	忄
覃 憛	忄
隋 憜	忄
心 憝	敦
敦 憞	忄
粟 憟	忄
心 憠	厥
策 憡	忄
番 憣	忄
贲 愤	忄
童 憧	忄
心 憨	敢
心 憩	舌 自
闵 悯	忄
景 憬	忄
尞 憭	忄
无 怃	忄
朁 憯	忄
矞 憰	忄
就 憱	忄
先 宪	宀
心 憵	辟
乙 忆	忄
楚 憷	忄
詹 憺	忄
亶 憻	忄
心 憼	敬
葱 憽	忄
感 憾	忄
敫 憿	忄
會 懀	忄
睘 懁	忄
董 懂	忄
心 懃	勤
勤 懄	忄
豦 懅	忄
喿 懆	忄
心 恳	艮
解 懈	忄
一 应	广 小
奥 懊	心
心 懋	楙
丨 怿	忄 又 二
禀 懔	忄
雋 懏	忄
不 怀	忄
赫 懗	忄
疑 懝	忄
蒙 懞	忄
心 怼	对
心 懑	满
壽 懤	忄
疐 懥	忄
需 懦	忄
厌 恹	忄
養 懩	忄
暴 懪	忄
憂 懮	忄
心 懯	敷
蔑 懱	忄
心 惩	征
懴
瞢 懵	忄
赖 懒	忄
不 怀	忄
心 悬	县
襄 懹	忄
千 忏	忄
冀 懻	忄
具 惧	忄
雚 懽	忄
聂 慑	忄
恣 懿	壹
心 恋	亦
靡 戂	忄
矍 戄	忄
心 戆	立 早 攵 页
丶 戈	一 乁 丿
戈 戊	丿
一 戌	戊
丶 戍	戊
戈 戎	一 十
㇆ 成	戊
戈 我	扌
戈 戒	廾
口 戓	戈
一 戋	戈
戈 戕	爿
戈 或	口 一
戈 戙	同
戈 戚	丿 上 小
戈 戛	一 自
呈 戜	戈
戈 戞	百 冖
戈 戟	十 早
戈 戠	音
戈 戡	甚
戈 戢	口 耳
戈 戣	癸
戈 戤	盈
戈 戥	星
戈 战	占
戈 戗	仓
戈 戨	哥
戈 戬	晋
隹 截	土 戈
或 戫	有
戈 戭	寅
戈 戮	翏
戈 战	占
戈 戯	虚
戈 戏	又
戈 戳	羽 隹
異 戴	土 戈
戈 戵	瞿
尸 户	丶
尸 戸	一
乙 戹	户
巳 戺	户
大 戻	户
戶 戼	㇆ 匸
斗 戽	户
大 戾	户
方 房	户
斤 所	户
冊 扁	户
占 扂	户
冋 扃	户
向 扄	户
多 扅	户
衣 扆	户
羽 扇	户
邑 扈	户
非 扉	户
炎 扊	户
亅 手	丿 二
丿 扌	一 亅
丿 才	一 亅
乚 扎	扌
九 扏	扌
力 扐	扌
八 扒	扌
丁 打	扌
乃 扔	扌
弗 拂	扌
土 扗	扌
乇 托	扌
丈 扙	扌
勺 扚	扌
工 扛	扌
于 扜	扌
亏 扝	扌
干 扞	扌
卂 扟	扌
叉 扠	扌
也 扡	扌
乞 扢	扌
口 扣	扌
兀 扤	扌
乚 扥	扌 丿 一
千 扦	扌
刄 扨	扌
丑 扭	扌
分 扮	扌
止 扯	扌
及 扱	扌
今 扲	扌
反 扳	扌
介 扴	扌
仒 扵	扌
夫 扶	扌
片 扸	扌
比 批	扌
氏 扺	扌
欠 扻	扌
厄 扼	扌
屯 扽	扌
戈 找	扌
三 承	氶
支 技	扌
允 抁	扌
王 抂	扌
卞 抃	扌
少 抄	扌
勾 抅	扌
文 抆	扌
日 抇	扌
月 抈	扌
夬 抉	扌
巴 把	扌
心 抋	扌
冘 抌	扌
升 抍	扌
云 抎	扌
元 抏	扌
抐
卬 抑	扌
予 抒	扌
爪 抓	扌
不 抔	扌
殳 投	扌
斗 抖	扌
亢 抗	扌
斤 折	扌
手 抙	扌
友 抜	扌
幻 抝	扌
丨 择	扌 又 二
丙 抦	扌
只 抧	扌
平 抨	扌
冉 抩	扌
布 抪	扌
皮 披	扌
台 抬	扌
儿 抭	扌 宀
彡 抮	扌 人
且 抯	扌
央 抰	扌
包 抱	扌
可 抲	扌
尼 抳	扌
世 抴	扌
氐 抵	扌
失 抶	扌
丕 抷	扌
乏 抸	扌
末 抹	扌
未 抺	扌
申 抻	扌
甲 押	扌
由 抽	扌
去 抾	扌
民 抿	扌
兄 拀	扌
加 拁	扌
弗 拂	扌
乍 拃	扌
主 拄	扌
斥 拆	扌
母 拇	扌
占 拈	扌
立 拉	扌
付 拊	扌
拋 抛	扌 尢 力
半 拌	扌
白 拍	扌
令 拎	扌
手 拏	奴
刀 拐	扌 口
甘 拑	扌
巨 拒	扌
石 拓	扌
犮 拔	扌
它 拕	扌
也 拖	扌 丿 一
幼 拗	扌
句 拘	扌
出 拙	扌
廾 拚	扌 厶
召 招	扌
手 拜	手
手 拜	手
丘 拞	扌
処 拠	扌
广 扩	扌
西 拪	扌
艮 拫	扌
舌 括	扌
式 拭	扌
吉 拮	扌
丞 拯	扌
任 拰	扌
共 拱	扌
手 拲	共
手 拳	𠔉
全 拴	扌
存 拵	扌
夕 拶	扌 巛
考 拷	扌
多 拸	扌
劦 拹	扌
朿 拺	扌
灰 拻	扌
并 拼	扌
曳 拽	扌
合 拾	扌
手 拿	合
氏 挀	扌 厂
寺 持	扌
至 挃	扌
光 挄	扌
朵 挆	扌
朵 挆	扌
旨 指	扌
手 挈	丰 刀
安 按	扌
下 挊	扌 上
臣 挋	扌
各 挌	扌
交 挍	扌
夸 挎	扌
同 挏	扌
手 挐	如
兆 挑	扌
列 挒	扌
宅 挓	扌
衣 挔	扌
耳 挕	扌
穵 挖	扌
夷 挗	扌
矣 挨	扌
兑 捝	扌
那 挪	扌
坐 挫	扌
孛 挬	扌
更 挭	扌
弟 挮	扌
辰 振	扌
呈 挰	扌
沙 挱	扌
手 挲	沙
每 挴	扌
弄 挵	扌
局 挶	扌
邦 挷	扌
邑 挹	扌
廷 挺	扌
延 挻	扌
妥 挼	扌
免 挽	扌
夹 挟	扌
夆 捀	扌
告 捁	扌
君 捃	扌
求 捄	扌
甬 捅	扌
困 捆	扌
赤 捇	扌
余 捈	扌
足 捉	扌
孚 捊	扌
寽 捋	扌
別 捌	扌
旱 捍	扌
肖 捎	扌
圼 捏	扌
肙 捐	扌
夨 捑	扌 日
束 捒	扌
邪 捓	扌
角 捔	扌
甫 捕	扌
完 捖	扌
步 捗	扌
夋 捘	扌
里 捚	扌
捛
叟 捜	扌
兵 捠	扌
宛 捥	扌
金 捦	扌
奉 捧	扌
舌 舍	人
戾 捩	扌
昏 捪	扌
门 扪	扌
府 捬	扌
卑 捭	扌
居 据	扌
到 捯	扌
果 捰	扌
矣 挨	扌
卷 捲	扌
岳 捳	扌
总 搃	扌
典 捵	扌
垂 捶	扌
疌 捷	扌
隶 捸	扌
奔 捹	扌
奈 捺	扌
念 捻	扌
委 捼	扌
卒 捽	扌
官 捾	扌
妻 捿	扌
欣 掀	扌
店 掂	扌
彐 扫	扌
仑 抡	扌
青 掅	扌
叕 掇	扌
受 授	扌
卓 掉	扌
咅 掊	扌
底 掋	扌
手 掌	尚 口
昆 掍	扌
奇 掎	扌
匋 掏	扌
臽 掐	扌
其 掑	扌
非 排	扌
叔 掓	扌
夌 掕	扌
夜 掖	扌
亚 挜	扌
屈 掘	扌
争 挣	扌
圭 挂	扌
兒 掜	扌
或 掝	扌
炎 掞	扌
定 掟	扌
京 掠	扌
木 采	爫
罙 探	扌
手 掣	制
朋 掤	扌
妾 接	扌
易 掦	扌
空 控	扌
隹 推	扌
奄 掩	扌
昔 措	扌
取 掫	扌
匊 掬	扌
忝 掭	扌
肩 掮	扌
肯 掯	扌
手 掰	手 分
手 掱	手 手
匕 掲	扌 日 勹
孟 掹	扌
掻
並 掽	扌
彖 掾	扌
若 掿	扌
一 拣	扌 东
酋 揂	扌
前 揃	扌
俞 揄	扌
手 揅	研
癸 揆	扌
南 揇	扌
訇 揈	扌
柔 揉	扌
畐 揊	扌
畏 揋	扌
思 揌	扌
奏 揍	扌
宣 揎	扌
苗 描	扌
是 提	扌
工 揑	扌 臼
臿 插	扌
施 揓	扌
总 搃	扌
甚 揕	扌
咠 揖	扌
盾 揗	扌
皇 揘	扌
扁 揙	扌
丿 扬	扌 弓 丿
奂 换	扌
弇 揜	扌
昝 揝	扌
音 揞	扌
胥 揟	扌
匽 揠	扌
屋 握	扌
客 揢	扌
耑 揣	扌
即 揤	扌
帝 揥	扌
剌 揦	扌
手 揧	剌
亭 揨	扌
皆 揩	扌
秋 揪	扌
手 揫	秋
突 揬	扌
曷 揭	扌
军 挥	扌
恒 搄	扌
重 揰	扌
手 揱	削
枼 揲	扌
契 揳	扌
爰 援	扌
建 揵	扌
耶 揶	扌
臼 揷	扌 千
查 揸	扌
月 背	北
击 揺	扌 爫
泵 揼	扌
冓 搆	扌
衾 搇	扌
容 搈	扌
隺 搉	扌
芻 搊	扌
虒 搋	扌
展 搌	扌
员 损	扌
尃 搏	扌
畜 搐	扌
茸 搑	扌
旁 搒	扌
差 搓	扌
蚤 搔	扌
盍 搕	扌
缶 摇	扌 爫
岛 捣	扌
耆 搘	扌
辱 搙	扌
脅 搚	扌
兼 搛	扌
叟 搜	扌
臭 搝	扌
高 搞	扌
朔 搠	扌
桑 搡	扌
烕 搣	扌
益 搤	扌
垂 捶	扌
弱 搦	扌
扇 搧	扌
羽 搨	扌 日
唐 搪	扌
手 搫	般
般 搬	扌
荅 搭	扌
栗 搮	扌
舀 搯	扌
骨 搰	扌
屖 搱	扌
窊 搲	扌
害 搳	扌
手 搴	宀 井 大
搵 揾	扌 昷
仓 抢	扌
真 搷	扌
秦 搸	扌
鬲 搹	扌
手 搻	合 手
拳 搼	扌
茶 搽	扌
窄 搾	扌
手 搿	手 合
吾 捂	扌
恩 摁	扌
聂 摄	扌
夕 摉	扌 穴 人
宿 摍	扌
翏 摎	扌
舂 摏	扌
從 摐	扌
国 掴	扌
屏 摒	扌
逢 摓	扌
率 摔	扌
祭 摖	扌
啇 摘	扌
堂 摚	扌
离 摛	扌
贯 掼	扌
鹿 摝	扌
累 摞	扌
娄 搂	扌
总 搃	扌
既 摡	扌
虖 摢	扌
虘 摣	扌
爽 摤	扌
瓠 摦	扌
崔 摧	扌
犀 摨	扌
手 摩	麻
竟 摬	扌
庶 摭	扌
手 摮	敖
手 挚	执
曼 摱	扌
区 抠	扌
雩 摴	扌
戚 摵	扌
专 抟	扌
巢 摷	扌
莫 摸	扌
手 摹	莫
斤 折	扌
参 掺	扌
票 摽	扌
强 摾	扌
音 摿	扌 人
手 撀	声 殳
畧 撂	扌
厥 撅	扌
手 撆	敝
敝 撇	扌
劳 捞	扌
手 撉	敦
日 撍	扌 旡 旡
壹 撎	扌
寻 挦	扌
掌 撑	扌
散 撒	扌
尧 挠	扌
景 撔	扌
斯 撕	扌
敢 撖	扌
撗
答 撘	扌
尊 撙	扌
然 撚	扌
粦 撛	扌
登 撜	扌
童 撞	扌
乔 挢	扌
戟 撠	扌
叅 撡	扌
覃 撢	扌
单 掸	扌
攵 撤	扌 育
发 拨	扌
奢 撦	扌
焦 撨	扌
尞 撩	扌
无 抚	扌
毳 撬	扌
番 播	扌
最 撮	扌
巽 撰	扌
隋 撱	扌
卜 扑	扌
钦 揿	扌
敦 撴	扌
觉 搅	扌
达 挞	扌
感 撼	扌
敫 撽	扌
过 挝	扌
佥 捡	扌
幹 擀	扌
用 拥	扌
雷 擂	扌
虏 掳	扌
亶 擅	扌
着 撯	扌
丨 择	扌 又 二
蜀 擉	扌
山 击	二
当 挡	扌
木 操	扌 品
手 擎	敬
敬 擏	扌
睘 擐	扌
戢 擑	扌
禽 擒	扌
旦 担	扌
隽 携	扌
葛 擖	扌
辟 擗	扌
手 擘	辟
夭 扷	扌
居 据	扌
葉 擛	扌
盟 擝	扌
齐 挤	扌
台 抬	扌
翟 擢	扌
鼻 擤	扌
察 擦	扌
手 挙	兴
歋 擨	扌
需 擩	扌
以 拟	扌
蒦 擭	扌
截 擮	扌
宾 摈	扌
宁 拧	扌
阁 搁	扌
郑 掷	扌 掷
广 扩	扌
摩 擵	扌
箭 擶	扌
颉 撷	扌
巤 擸	扌
歎 擹	扌
罢 摆	扌
数 擞	扌
鲁 撸	扌
尤 扰	扌
手 攀	林 爻 大
養 攁	扌
畾 攂	扌
蔡 攃	扌
虑 摅	扌
辇 撵	扌
麇 攈	扌
霍 攉	扌
圜 攌	扌
嬴 攍	扌
龙 拢	扌
褰 攐	扌
蹇 攓	扌
兰 拦	扌
韱 攕	扌
婴 撄	扌
麋 攗	扌
襄 攘	扌
冫 搀	扌 免
窜 撺	扌
隽 携	扌
聂 摄	扌
麕 攟	扌
靡 攠	扌
赞 攒	扌
手 挛	亦
难 摊	扌
纂 攥	扌
瓜 攨	扌 穴 瓜 瓜
觉 搅	扌
瞿 攫	扌
览 揽	扌
蠡 攭	扌
囊 攮	扌
又 支	十
力 攰	支
支 攱	立
支 攲	奇
又 攴	卜
乂 攵	丿 一
攵 收	丩
攵 攷	丂
攵 攸	亻 丨
攵 改	己
攵 攺	已
攵 攻	工
攵 攼	干
攵 攽	分
攵 放	方
攵 政	正
攵 敀	白
攴 敁	占
攵 敂	句
攵 敃	民
攵 敄	矛
攵 故	古
攴 敆	合
攵 敇	朿
攵 效	交
攵 敉	米
攴 敊	尗
攵 敋	各
攴 敍	余
攵 教	孝
攵 敏	每
攵 敐	辰
攵 救	求
攵 敒	伸
攵 敚	兑
攵 敔	吾
攵 敕	束
攵 敖	土 方
攵 败	贝
又 叙	余
攵 教	孝
攵 敜	念
攵 敝	丷 巾 八
攵 敞	尚
攵 敟	典
攴 敠	叕
攴 敡	易
攵 敢	丅 耳
攵 散	井 月
攴 敤	果
攴 敥	炎
攵 敦	享
攴 敧	奇
攵 敨	咅
攵 敪	叕
攵 敫	白 方
攵 敬	茍
攵 敭	易
攴 敮	臿
攴 敯	昬
攴 敱	豈
攵 敲	高
正 整	束 攵
攵 敌	舌
攵 敷	旉
攵 数	娄
攵 敹	卜 冖 一 米
夂 敻	刀 内 目
攴 敼	喜
攴 斀	蜀
攵 敛	佥
死 毙	比
攵 敩	学
攵 敩	学
乂 文	亠
子 斈	文
丨 齐	文 丿
耳 斊	文
武 斌	文
而 斋	文
文 斐	非
王 斑	玉 文
扁 斒	文
臾 斔	文 虫
阑 斓	文
且 斖	文 臼 同 冖
丨 斗	丶 丶 一
斗 斘	夕
斗 料	米
斗 斚	厶 厶 冖
斗 斛	角
斗 斜	余
斗 斝	口 口 冖
斗 斞	臾
斗 斟	甚
斗 斠	冓
斗 斡	十 日 十 人
斗 斢	黃
斗 斣	蜀
丅 斤	厂
丶 斥	斤
斤 斦	斤
斤 斧	父
斤 斨	爿
斤 斪	句
斤 斫	石
斤 斩	车
斤 斮	昔
斤 斯	其
斤 新	立 木
斤 斱	者
斤 斳	堇
斤 斴	粦
斤 斵	卯 亞
蜀 斶	斤
斤 断	丨 一 米
刀 方	亠
介 斺	方 丿 一
亢 斻	方
亅 于	二
也 施	方 丿 一
巾 斾	方 丿 一
子 斿	方 丿 一
方 旁	亠 丷 冖
斤 旂	方 丿 一
円 旃	方 丿 一
毛 旄	方 丿 一
氏 旅	方 丿 一
巿 旆	方 丿 一
皮 旇	方 丿 一
巟 旈	方
方 旉	甫
瓦 旊	方 丿 一
疋 旋	方 丿 一
生 旌	方 丿 一
令 旍	方 丿 一
尼 旎	方 丿 一
矢 族	方 丿 一
兆 旐	方 丿 一
奇 旑	方
巟 旒	方 丿 一
肖 旓	方 丿 一
建 旔	方
奇 旖	方 丿 一
其 旗	方 丿 一
番 旙	方
票 旚	方 丿 一
番 旛	方 丿 一
亶 旜	方 丿 一
會 旝	方 丿 一
遂 旞	方 丿 一
乚 旡	匸 丿
旡 既	艮
旡 旣	白 匕
丶 日	口
一 旦	日
日 旨	匕
十 早	日
十 旪	日
刀 旫	日
日 旬	勹
日 旭	九
日 旮	九
九 旯	日
干 旰	日
干 旱	日
大 旲	日
勺 旳	日
于 旴	日
山 旵	日
日 旹	屮 一
王 旺	日
文 旻	日
文 旼	日
屯 旽	日
日 旾	屯
午 旿	日
匀 昀	日
巿 昁	日
卬 昂	日
仄 昃	日
反 昄	日
及 昅	日
比 昆	日
升 昇	日
户 昈	日
方 昉	日
天 昊	日
日 昋	夭
日 昌	日
日 昍	日
月 明	日
日 昏	氏
分 昐	日
今 昑	日
勿 昒	日
勿 易	日
日 昔	井
斤 昕	日
公 昖	日
六 昗	日
方 昘	日
日 昚	大 丷
巨 昛	日
勿 昜	日 一
日 昝	处
丙 昞	日
日 星	生
央 映	日
玄 昡	日
出 昢	日
彡 昣	日 人
令 昤	日
日 春	龹
夰 昦	日
未 昧	日
乍 昨	日
末 昩	日
弁 昪	日
句 昫	日
日 昬	民
召 昭	日
功 昮	日
疋 是	曰
正 昰	日
立 昱	日
弗 昲	日
失 昳	日
卯 昴	日
日 昶	永
皿 昷	日
冬 昸	日
永 昹	日
丙 昺	日
卬 昻	日
广 旷	日
兆 晀	日
兆 晁	日
寸 时	日
光 晃	日
光 晄	日
亘 晅	日
圭 晆	日
夸 晇	日
交 晈	日
日 晋	亚
至 晊	日
向 晌	日
同 晍	日
共 晎	日
安 晏	日
亥 晐	日
向 晑	日
含 晗	日
旱 晘	日
夋 晙	日
免 晚	日
弟 晜	日
旦 昼	尺
希 晞	日
成 晟	日
成 晠	日
甫 晡	日
日 晢	折
折 晣	日
吾 晤	日
完 晥	日
每 晦	日
告 晧	日
辰 晨	日
免 晩	日
典 晪	日
卓 晫	日
卒 晬	日
周 晭	日
晋 普	丷
京 景	日
析 晰	日
炎 晱	日
兒 晲	日
日 晳	析
青 晴	日
攵 晵	户
日 晶	日 日
咎 晷	日
政 晸	日
易 晹	日
日 智	知
奄 晻	日
宛 晼	日
林 晽	日
京 晾	日
昌 晿	日
往 暀	日
尧 晓	日
宣 暄	日
恒 暅	日
施 暆	日
叚 暇	日
军 晕	日
军 晖	日
日 暋	敃
癸 暌	日
曷 暍	日
英 暎	日
者 暏	日
者 暑	日
星 暒	日
日 暓	敄
南 暔	日
柬 暕	日
爰 暖	日
音 暗	日
丿 旸	日 弓 丿
春 暙	日
缶 暚	日 爫
差 暛	日
日 暜	立 立
冥 暝	日
臬 暞	日
高 暠	日
翁 暡	日
丿 畅	申 弓 丿
皋 暤	日
妟 暥	日
日 暦	厂 林
旦 暨	既
祭 暩	日
日 暂	斩
皐 暭	日
日 暮	莫
莫 暯	日
尼 昵	日
章 暲	日
彗 暳	日
恭 暴	日
大 暵	日 革
旋 暶	日
尞 暸	日
進 暹	日
單 暺	日
景 暻	日
日 暼	敝
粦 暽	日
敦 暾	日
喜 暿	日
壹 曀	日
旦 曁	旣
黄 曂	日
逮 曃	日
华 晔	日
力 历	厂
云 昙	日
童 曈	日
尧 晓	日
覃 曋	日
空 曌	明
臯 曍	日
生 曐	晶
彡 曑	晶 人
敫 曒	日
本 曓	日 出 大
敬 曔	日
詹 曕	日
爱 暧	日
需 曘	日
署 曙	日
蒙 曚	日
熏 曛	日
翟 曜	日
暴 曝	日
辰 曟	晶
广 旷	日
冝 曡	晶
燕 曣	日
霍 曤	日
羲 曦	日
融 曧	日
龙 昽	日
囊 曩	日
西 晒	日
一 曰	曰
丅 曱	口
丨 曲	曰 丨
丿 曳	曰 乁
人 更	一 曰
丶 曵	日  乀 丿
日 曶	勿
人 曷	日 勹 丨 一
丶 书	㇆ ㇆ 丨
日 曹	一 丨 丨 曰
日 曺	一 由
又 曼	曰 目
日 曽	丷 田
曰 曾	八 口 丨 丷
日 替	夫 夫
取 最	日
日 朁	兓
力 朂	日 耳
云 会	人
曷 朅	去
勿 朆	曾
一 月	冂 一
月 有	一 丿
元 朊	月
月 朋	月
分 朌	月
又 服	月 卩
令 朎	月
出 朏	月
句 朐	月
肉 朒	月
兆 朓	月
月 朔	屰
关 朕	月
良 朖	月
月 朗	良
夋 朘	月
月 朙	囧
明 朚	亡
王 望	亡 月
享 朜	月
月 朝	卓
月 朞	其
月 期	其
英 朠	月
夂 朡	月 凶 八
童 朣	月
月 朤	月 月 月
蒙 朦	月
龙 胧	月
八 木	十
小 朩	一
木 未	一
一 末	木
一 本	木
乚 札	木
丶 朮	十 儿
未 朱	丶
人 朲	木
八 朳	木
卜 朴	木
木 朵	几
木 朵	几
刀 朷	木
力 朸	木
九 朹	木
丩 朻	木
匕 朼	木
丂 朽	木
丁 朾	木
冂 朿	木
千 杄	木
于 杅	木
干 杆	木
亏 杇	木
叉 杈	木
彡 杉	木
川 杊	木
凡 杋	木
兀 杌	木
子 杍	木
子 李	木
口 杏	木
才 材	木
寸 村	木
刃 杒	木
勺 杓	木
乇 杔	木
大 杕	木
丈 杖	木
亡 杗	木
木 杘	尸
弋 杙	木
乞 杚	木
弓 杛	木
土 杜	木
也 杝	木
己 杞	木
口 束	木
工 杠	木
亡 杧	木
少 杪	木
止 杫	木
元 杬	木
亢 杭	木
巿 杮	木
不 杯	木
灬 杰	木
小 东	一 𠃋
木 杲	日
日 杳	木
欠 杴	木
午 杵	木
屯 杶	木
巴 杷	木
殳 杸	木
化 杹	木
心 杺	木
丑 杻	木
予 杼	木
手 杽	木
公 松	木
反 板	木
木 枀	公
月 枂	木
匀 枃	木
开 枅	木
毛 枆	木
比 枇	木
木 枈	比
王 枉	木
卬 枊	木
方 枋	木
分 枌	木
兮 枍	木
夫 枎	木
冄 枏	木
斤 析	木
互 枑	木
牙 枒	木
斗 枓	木
今 枔	木
冘 枕	木
夭 枖	木
木 林	木
内 枘	木
厄 枙	木
攵 枚	木
爪 枛	木
木 果	日
支 枝	木
升 枡	木
丹 枬	木
占 枮	木
古 枯	木
平 枰	木
口 台	厶
木 枲	台
只 枳	木
号 枵	木
木 架	加
加 枷	木
句 枸	木
包 枹	木
末 枺	木
世 枻	木
木 枼	世
木 枽	卋
丨 枾	木 亠 十 丿
卉 枿	木
皮 柀	木
它 柁	木
也 柂	木 丿 一
令 柃	木
丙 柄	木
尼 柅	木
立 柆	木
禾 柇	木
半 柈	木
乏 柉	木
冬 柊	木
木 柋	代
司 柌	木
央 柍	木
付 柎	木
白 柏	木
木 某	甘
甘 柑	木
木 柒	氵 七
木 染	氵 九
木 柔	矛
矛 柕	木
召 柖	木
口 柗	木 八
石 柘	木
甲 柙	木
由 柚	木
申 柛	木
拆 柝	木
乍 柞	木
冉 柟	木
水 柡	木 二
氐 柢	木
失 柣	木
且 柤	木
旦 查	木
旦 柦	木
瓜 柧	木
久 柩	木
幼 柪	木
弗 柫	木
丷 柬	木 囗
犮 柭	木
出 柮	木
可 柯	木
示 柰	木
主 柱	木
必 柲	木
卯 柳	木
木 柴	此
册 栅	木
四 柶	木
兄 柷	木
丕 柸	木
丿 柹	木 丿 ㇉ 丨
另 拐	扌
且 査	木
穴 柼	木
正 柾	木
市 柿	木
卮 栀	木
卩 栁	木 夕
母 栂	木
木 荣	艸 冖
永 栐	木
旬 栒	木
全 栓	木
木 栔	丰 刀
臣 栕	木
木 栗	襾
多 栘	木
夅 栙	木
关 栚	木
劦 栛	木
朿 栜	木
舌 栝	木
木 栞	干 干
并 栟	木
木 栠	任
交 校	木
百 栢	木
任 栣	木
冰 栤	木
木 栥	次
州 栦	木
曳 栧	木
次 栨	木
羽 栩	木
朱 株	木
存 栫	木
色 栬	木
而 栭	木
耳 栮	木
有 栯	木
伐 栰	木
共 栱	木
考 栲	木
老 栳	木
円 栴	木 丿 一
列 栵	木
亥 核	木
艮 根	木
旨 栺	木
式 栻	木
各 格	木
木 栽	土 戈
伏 栿	木
木 桀	舛
行 桁	木
圭 桂	木
兆 桃	木
光 桄	木
危 桅	木
匡 框	木
木 桇	如
木 案	安
安 桉	木
木 桊	𠔉
夷 桋	木
日 桌	木 卜
夸 桍	木
至 桎	木
邛 桏	木
同 桐	木
又 桑	木 又 又
木 桒	卉
亘 桓	木
吉 桔	木
臼 桕	木
血 桖	木
朶 桗	木
一 桘	木 户 乛
牟 桙	木
夕 桚	木 巛
婴 樱	木
戋 栈	木
沙 桫	木
木 桬	沙
辰 桭	木
否 桮	木
呈 桯	木
口 桰	木 氏
孛 桲	木
十 桳	木 厶 大
孚 桴	木
妥 桵	木
甬 桶	木
角 桷	木
希 桸	木
良 桹	木
丣 桺	木
夆 桻	木
水 桼	木
坐 桽	木
君 桾	木
干 杆	木
束 梀	木
木 梁	氵 刅
求 梂	木
廷 梃	木
酉 梄	木
每 梅	木
邦 梆	木
弄 梇	木
亨 梈	木
木 梊	折
肙 梋	木
余 梌	木
七 梍	木 白
皂 梎	木
口 梏	木 牛
土 梐	木 比
狄 梑	木
含 梒	木
辛 梓	木
巵 梔	木
忍 梕	木
更 梗	木
见 枧	木
串 梙	木
免 梚	木
那 梛	木
木 条	夂
忌 梞	木
木 枭	鸟
完 梡	木
肖 梢	木
岑 梣	木
分 梤	木 山
枀 梥	宀
吾 梧	木
木 梨	利
里 梩	木
豆 梪	木
又 梫	木 彐 冖
甹 梬	木
夋 梭	木
局 梮	木
弟 梯	木
戒 械	木
困 梱	木
兑 棁	木
巟 梳	木
延 梴	木
凡 梵	木 木
尾 梶	木
木 梷	占 又
利 梸	木
兵 梹	木
志 梽	木
木 棃	禾 勹 丿
廾 弃	亠 厶
秉 棅	木
心 棇	木 公
青 棈	木
帛 棉	木
木 棊	其
其 棋	木
采 棌	木
昆 棍	木
穼 棎	木
寸 棏	木 日 一
木 棐	非
非 棑	木
奉 棒	木
咅 棓	木
昏 棔	木
宗 棕	木
长 枨	木
冫 枣	朿
朿 棘	朿
戾 棙	木
朋 棚	木
育 棛	木
固 棝	木
禾 棞	木 囗
东 栋	木
木 棠	尚
罔 棢	木
隶 棣	木
昔 棤	木
爻 棥	林
戋 栈	木
攵 棨	户
炎 棪	木
或 棫	木
卷 棬	木
夜 棭	木
林 森	木
念 棯	木
垂 棰	木
夌 棱	木
西 栖	木
叕 棳	木
服 棴	木
果 棵	木
来 梾	木
取 棷	木
木 棸	取
卓 棹	木
官 棺	木
木 棻	芬
分 棼	林
今 棽	林
冗 棾	林
兒 棿	木
宛 椀	木
享 椁	木
录 椂	木
虎 椃	木
妾 椄	木
奇 椅	木
周 椆	木
具 椇	木
匊 椈	木
木 椉	亠 舛
卒 椊	木
京 椋	木
空 椌	木
直 植	木
隹 椎	木
亚 桠	木
居 椐	木
卑 椑	木
叔 椒	木
豖 椓	木
甾 椔	木
木 椕	木 分
房 椖	木
定 椗	木
之 椘	林
佥 检	木
木 椞	析
知 椥	木
並 椪	木
耑 椯	木
耶 椰	木
复 椱	木
畏 椳	木
段 椴	木
叚 椵	木
夂 椶	木 凶 八
咸 椷	木
施 椸	木
甚 椹	木
保 椺	木
匽 椻	木
衍 椼	木
彖 椽	木
前 椾	木
春 椿	木
禹 楀	木
客 楁	木
查 楂	木
屋 楃	木
扁 楄	木
畐 楅	木
要 楆	木
月 楈	木 疋
若 楉	木
丿 杨	木 弓 丿
剌 楋	木
彦 楌	木
口 楍	木 口 口
奎 楏	木
界 楐	木
癸 楑	木
思 楒	木
风 枫	木
契 楔	木
月 楕	木 左
即 楖	木
建 楗	木
木 楘	敄
木 楙	木 矛
疋 楚	林
苦 楛	木
胡 楜	木
柬 楝	木
方 愣	忄 罒
亭 楟	木
南 楠	木
俞 楡	木
酋 楢	木
眉 楣	木
怱 楤	木
爰 楥	木
宣 楦	木
英 楧	木
贞 桢	木
便 楩	木
枼 楪	木
耳 楫	木 口
曷 楬	木
一 业	丨 丨 丷
者 楮	木
盾 楯	木
臾 楰	木
奏 楱	木
威 楲	木
某 楳	木
帝 楴	木
及 极	木
呆 楶	次
皆 楷	木
秋 楸	木
盈 楹	木
柔 楺	木
皇 楻	木
朩 乐	丿 丨
品 榀	木
既 概	木
田 榃	林
俞 榆	木
神 榊	木
屑 榍	木
夏 榎	木
益 榏	木
展 榐	木
尃 榑	木
弱 榒	木
皿 榓	木 必
郎 榔	木
容 榕	木
殳 榖	士 冖 一 木
木 榘	矩
荅 榙	木
羔 榚	木
秦 榛	木
旁 榜	木
原 榞	木
宰 榟	木
冥 榠	木
素 榡	木
家 榢	木
桀 榤	木
晃 榥	木
木 榦	十 日 十 人
匪 榧	木
窄 榨	木
虔 榩	木
马 杩	木
十 榫	木 隹
袁 榬	木
射 榭	木
木 荣	艸 冖
耆 榰	木
衰 榱	木
昷 榅	木
庭 榳	木
留 榴	木
茸 榵	木
唐 榶	木
隺 榷	木
埋 榸	木
虒 榹	木
桊 榺	月
羽 榻	木 曰
盍 榼	木
奚 榽	木
骨 榾	木
岂 桤	木
木 槀	高
高 槁	木
木 槃	般
舀 槄	木
鬲 槅	木
荀 槆	木
真 槇	木
辱 槈	木
疾 槉	木
朔 槊	木
勾 构	木
追 槌	木
仓 枪	木
差 槎	木
兼 槏	木
鬼 槐	木
呆 槑	呆
畜 槒	木
工 杠	木
皋 槔	木
卓 槕	木
木 槖	士 冖 石
羊 样	木
真 槙	木
隽 槜	木
習 槢	木
寄 槣	木
连 梿	木
彗 槥	木
庸 槦	木
斩 椠	木
郭 槨	木
既 槩	木
既 概	木
瓠 槬	木
戚 槭	木
参 椮	木
崔 槯	木
逢 槰	木
灬 槱	木 酉
斛 槲	木
木 桨	丬 夕
扈 槴	木
患 槵	木
木 槷	埶
埶 槸	木
皐 槹	木
康 槺	木
规 椝	木
曹 槽	木
曼 槾	木
堇 槿	木
啇 樀	木
庄 桩	木
小 乐	匚
朗 樃	木
从 枞	木
离 樆	木
脩 樇	木
竟 樈	木
爽 樉	木
大 樊	棥
通 樋	木
宿 樎	木
累 樏	木
梁 樑	木
密 樒	木
娄 楼	木
巢 樔	木
欶 樕	木
柯 樖	合
雩 樗	木
堂 樘	木
示 标	木
鹿 樚	木
翏 樛	木
庶 樜	木
虘 樝	木
区 枢	木
章 樟	木
莫 模	木
羊 样	木
莑 樥	木
主 樦	木 竹
殺 榝	木
犀 樨	木
又 权	木
悤 樬	木
寻 桪	木
只 枳	木
焦 樵	木
最 樶	木
取 樷	林
卜 朴	木
寸 树	木 又
华 桦	木
孱 樼	木
尊 樽	木
越 樾	木
单 椫	木
皿 橀	木 巟
奠 橂	木
敢 橄	木
林 橆	丿 一 卌 一
毳 橇	木
尧 桡	木
粦 橉	木
畱 橊	木
乔 桥	木
番 橎	木
善 橏	木
石 橐	一 中 冖 木
尞 橑	木
云 枟	木
舜 橓	木
敦 橔	木
棠 橖	木
萌 橗	木
矞 橘	木
登 橙	木
厥 橛	木
木 橜	厥
覃 橝	木
惠 橞	木
几 机	木
袲 橠	木
象 橡	木
橢 椭	木 隋
甯 橣	木
木 橤	惢
童 橦	木
曾 橧	木
然 橪	木
黄 横	木
朁 橬	木
辜 橭	木
臯 橰	木
戟 橶	木
几 橷	木 北 白
喿 橾	木
畺 橿	木
亶 檀	木
禀 檩	木
敫 檄	木
歲 檅	木
煔 檆	木
雋 檇	木
睘 檈	木
圣 柽	木
幹 檊	木
罪 檌	木
意 檍	木
禽 檎	木
雷 檑	木
毀 檓	木
当 档	木
木 檕	車 凵 殳
遂 檖	木
木 檗	辟
辟 檘	木
鼎 檙	木
楚 檚	木
会 桧	木
戢 檝	木
解 檞	木
贾 槚	木
木 檠	敬
佥 检	木
啬 樯	木
道 檤	木
剽 檦	木
葱 檧	木
羨 檨	木
察 檫	木
蒙 檬	木
寿 梼	木
口 台	厶
箕 檱	木
宾 槟	木
蒦 檴	木
幺 檵	木 丨 一 幺 幺 一 幺
宁 柠	木
旖 檹	木
豪 檺	木
监 槛	木
需 檽	木
木 檿	壓
綦 櫀	木
蜜 櫁	木
翟 櫂	木
巨 柜	木
熏 櫄	木
魁 櫆	木
凳 櫈	木
厨 橱	木
臱 櫋	木
遷 櫏	木
木 櫐	畾
畾 櫑	木
蔡 櫒	木
鲁 橹	木
蔑 櫗	木
慧 櫘	木
吕 榈	木 门
节 栉	木
呆 櫜	一 中 冂 处
卖 椟	木
缘 橼	木
乐 栎	木
箸 櫡	木
厨 橱	木
诸 槠	木
卢 栌	木
历 枥	木
猪 橥	木
亲 榇	木
暨 櫭	木
噩 櫮	木
褱 櫰	木
木 櫱	辥
豫 櫲	木
龙 栊	木
举 榉	木
霝 櫺	木
婴 樱	木
韱 櫼	木
系 櫾	木 爫 缶
襄 欀	木
薄 欂	木
毚 欃	木
兰 栏	木
聶 欇	木
巂 欈	木
又 权	木
瞿 欋	木
寸 欎	棥 冖 艮
罗 椤	木
木 栾	亦
矍 欔	木
览 榄	木
纍 欙	木
蠡 欚	木
囊 欜	木
寸 欝	棥 罒 艮
灵 棂	木
人 欠	刀
欠 次	冰
欠 欣	斤
欠 欥	日
欠 欦	今
欠 欨	句
欠 欩	召
欠 欪	出
欠 欫	午 止
欠 欬	亥
欠 欭	因
欠 欮	屰
欠 欯	吉
欠 欰	血
欠 欱	合
欠 欲	谷
欠 欳	卜 冊
欠 欴	良
欠 欵	匕 矢
欠 欶	束
欠 欷	希
欠 欸	矣
欠 欹	奇
欠 欺	其
欠 欻	炎
欠 欼	叕
欠 钦	钅
欠 款	士 示
欠 欿	臽
欠 歀	柰
欠 歁	甚
欠 歂	耑
欠 歃	臿
欠 歅	垔
欠 歆	音
欠 歇	曷
欠 歈	俞
欠 歉	兼
欠 歊	高
欠 歋	虒
欠 歌	哥
又 叹	口
欠 歏	堇
欠 欧	区
欠 歑	虖
欠 歒	啇
欠 欢	又
欠 歔	虚
欠 歖	喜
欠 歘	焱
欠 歙	翕
欠 歜	蜀
欠 欤	与
欠 歠	叕 酉
欠 欢	又
丨 止	上
止 正	一
匕 此	止
丿 步	止 亅 丶
止 武	一 弋
支 歧	止
人 歨	止 卜
少 歩	止
正 歪	不
巨 歫	止
舟 歬	止
寺 歭	止
止 歮	止 止
凵 齿	止 人
止 歰	刃 刃 止
重 歱	止
夕 岁	山
夕 岁	山
止 歴	厂 林
禺 歶	此
力 历	厂
彐 归	丨 丿
夕 歹	一
夕 歺	卜
匕 死	一 夕
斤 歽	歹
勿 歾	歹
殳 殁	歹
夭 殀	歹
且 殂	歹
央 殃	歹
彡 殄	歹 人
生 殅	歹
台 殆	歹
血 殈	歹
旬 殉	歹
朱 殊	歹
孚 殍	歹
求 殏	歹
束 殐	歹
克 殑	歹
隶 殔	歹
咅 殕	歹
直 殖	歹
奄 殗	歹
戋 残	歹
昏 殙	歹
亟 殛	歹
枼 殜	歹
员 殒	歹
昷 殟	歹
臭 殠	歹
帶 殢	歹
堇 殣	歹
丿 殇	歹 丿 一 弓 丿
寅 殥	歹
就 殧	歹
粲 殩	歹
壹 殪	歹
单 殚	歹
畺 僵	亻
佥 殓	歹
宾 殡	歹
千 歼	歹
又 殳	几
殳 段	丿 丰
殳 殶	主
殳 殷	㐆
殳 殸	声
殳 殹	医
木 杀	乂
冗 壳	士
冗 壳	士
殳 殽	肴
殳 殾	者
殳 殿	尸 共
殳 毁	臼 工
殳 毃	高
殳 毅	立 豕
殳 殴	区
殳 毇	臼 米
段 毈	卵
巫 毉	殹
亅 母	丨 一 二 丶 丶
母 每	丿 一
母 每	丿 一
母 毐	士
也 毑	母
母 毒	丰
巟 毓	每
匕 比	匕
必 毖	比
比 毗	田
比 毘	田
兔 毚	刀 口 比
匕 毛	丿 一
毛 毞	比
毛 毠	加
西 毢	毛
毛 毣	羽
毛 毤	兊
旬 毥	毛
毛 毦	耳
戎 毧	毛
先 毨	毛
米 毩	毛
牟 毪	毛
毛 毫	亠 口 冂
求 毬	毛
毛 毭	豆
炎 毯	毛
咅 毰	毛
匊 毱	毛
毛 毲	叕
毛 毳	毛 毛
非 毴	毛
毛 毷	冒
思 毸	毛
毛 毹	俞
俞 毺	毛
毛 毻	左 月
毛 毼	曷
建 毽	毛
毛 毾	日 羽
毛 毵	参
莫 氁	毛
毛 牦	牜
毛 氃	童
毛 氄	矞
毛 氅	敞
普 氆	毛
占 毡	毛
毛 氉	喿
占 毡	毛
毛 氋	蒙
鲁 氇	毛
毛 氍	瞿
毛 氎	畾 宀 彑
丶 氐	氏
十 氒	氏
民 氓	亡
丿 氕	气
乃 氖	气
乙 气	丿 一 一
丨 氘	气 丿
山 氙	气
川 氚	气
分 氛	气
日 氜	气
內 氝	气
弗 氟	气
申 氠	气
冬 氡	气
乙 气	丿 一 一
因 氤	气
西 氥	气
亥 氦	气
羊 氧	气
安 氨	气
克 氪	气
圣 氢	气
亚 氩	气
炎 氮	气
录 氯	气
青 氰	气
昷 氲	气
乀 水	乛 亅 丶
丿 氵	丶 丶
乀 氶	了 ㇆ 丶
水 氷	丶
水 永	丶 一
水 氹	乙
力 氻	氵
人 氼	水
水 氽	人
卩 氾	氵
九 氿	氵
丁 汀	氵
十 汁	氵
丶 求	水 一
八 汃	氵
人 汄	氵
丂 汅	氵
水 汆	入
刁 汈	氵
叉 汊	氵
勺 汋	氵
川 汌	氵
丸 汍	氵
凡 汎	氵
大 汏	氵
夕 汐	氵
乇 汑	氵
亡 汒	氵
子 汓	氵
乞 汔	氵
山 汕	氵
水 汖	山
干 汗	氵
千 汘	氵
亏 污	氵
亏 污	氵
卂 汛	氵
巳 汜	氵
女 汝	氵
水 汞	工
工 江	氵
也 池	氵
亏 污	氵
支 汥	氵
氏 汦	氵
开 汧	氵
日 汨	氵
日 汩	氵
王 汪	氵
井 汫	氵
水 汬	井
汭
勻 汮	氵
厷 汯	氵
太 汰	氵
犬 汱	氵
及 汲	氵
反 汳	氵
卞 汴	氵
今 汵	氵
文 汶	氵
攵 汷	氵
方 汸	氵
夬 决	冫
午 汻	氵
气 汽	氵
分 汾	氵
予 汿	氵
予 沀	水
心 沁	氵
斤 沂	氵
夭 沃	氵
元 沅	氵
亢 沆	氵
允 沇	氵
冘 沈	氵
水 沊	冘
屯 沌	氵
互 沍	氵
化 沎	氵
切 沏	氵
木 沐	氵
丑 沑	氵
殳 没	氵
日 沓	氵
丏 沔	氵
勿 沕	氵
中 冲	冰
水 沗	天
比 沘	氵
少 沙	氵
止 沚	氵
巿 沛	氵
片 沜	氵
水 沝	水
帀 沞	氵
爪 沠	氵
丨 泽	氵 又 二
丰 沣	氵
末 沫	氵
未 沬	氵
朮 沭	氵
且 沮	氵
石 沯	水
石 沰	氵
它 沱	氵
也 沲	氵 丿 一
可 河	氵
彡 沴	氵 人
示 沶	氵
犮 沷	氵
弗 沸	氵
由 油	氵
田 沺	氵
台 治	氵
召 沼	氵
古 沽	氵
占 沾	氵
口 沿	氵 八
司 泀	氵
兄 况	冫
冋 泂	氵
句 泃	氵
世 泄	氵
囚 泅	氵
失 泆	氵
加 泇	氵
冬 泈	氵
水 泉	白
白 泊	氵
卉 泋	氵
必 泌	氵
本 泍	氵
乍 泎	氵
出 泏	氵
阞 泐	氵
幼 泑	氵
瓜 泒	氵
弘 泓	氵
甘 泔	氵
去 法	氵
卯 泖	氵
四 泗	氵
乎 泘	氵
平 泙	氵
此 泚	氵
乏 泛	氵
氐 泜	氵
斥 泝	氵
正 泟	氵
令 泠	氵
包 泡	氵
皮 波	氵
立 泣	氵
以 泤	氵
尼 泥	氵
尻 泦	氵
戉 泧	氵
主 注	氵
生 泩	氵
玄 泫	氵
穴 泬	氵
付 泭	氵
半 泮	氵
民 泯	氵
水 泰	龹
央 泱	氵
丿 泲	氵 丿 ㇉ 丨
永 泳	氵
皿 泴	水
水 泵	石
艮 泿	氵
舟 洀	氵
亦 洂	氵
灰 洃	氵
回 洄	氵
再 洅	氵
丞 洆	氵
因 洇	氵
危 洈	氵
后 洉	氵
存 洊	氵
羊 洋	氵
列 洌	氵
自 洎	氵
而 洏	氵
行 洐	氵
伏 洑	氵
朿 洓	氵
寺 洔	氵
肉 洕	氵 水 八
吳 洖	氵
先 洗	氵
考 洘	氵
朱 洙	氵
夅 洚	氵
各 洛	氵
安 洝	氵
同 洞	氵
夷 洟	氵
牟 洠	氵
耒 洡	氵
伊 洢	氵
米 洣	氵
全 洤	氵
聿 津	氵
百 洦	氵
有 洧	氵
交 洨	氵
曳 洩	氵
共 洪	氵
血 洫	氵
夙 洬	氵
匡 洭	氵
兆 洮	氵
刀 洯	氵 丰
巨 洰	氵
耳 洱	氵
州 洲	氵
如 洳	氵
并 洴	氵
旬 洵	氵
凶 汹	氵
至 洷	氵
光 洸	氵
亘 洹	氵
名 洺	氵
舌 活	氵
合 洽	氵
氏 派	氵 厂
夸 洿	氵
曲 浀	氵
川 流	氵 亠 厶
关 浂	氵
争 净	冫
寽 浖	氵
求 浗	氵
尾 浘	氵
折 浙	氵
夋 浚	氵
含 浛	氵
兵 浜	氵
尨 浝	氵
足 浞	氵
攸 浟	氵
希 浠	氵
孛 浡	氵
豆 浢	氵
完 浣	氵
宏 浤	氵
邑 浥	氵
甫 浦	氵
呈 浧	氵
宋 浨	氵
告 浩	氵
良 浪	氵
罕 浫	氵
里 浬	氵
更 浭	氵
孚 浮	氵
吾 浯	氵
利 浰	氵
辰 浱	氵
夆 浲	氵
肉 浳	氵 弋
谷 浴	氵
彤 浵	氵
牢 浶	氵
每 海	氵
又 浸	氵 彐 冖
夹 浃	氵
忡 浺	氵
冏 浻	氵
免 浼	氵
妥 浽	氵
赤 浾	氵
杉 涁	氵
余 涂	氵
困 涃	氵
甹 涄	氵
圼 涅	氵
旰 涆	氵
圣 泾	氵
肖 消	氵
步 涉	氵
忍 涊	氵
宊 涋	氵
孝 涍	氵
延 涎	氵
廷 涏	氵
我 涐	氵
束 涑	氵
君 涒	氵
肙 涓	氵
岑 涔	氵
弟 涕	氵
位 涖	氵
兑 涚	氵
矣 涘	氵
戻 涙	氵
卖 渎	氵
咅 涪	氵
官 涫	氵
幸 涬	氵
受 涭	氵
刷 涮	氵
厓 涯	氵
叕 涰	氵
夜 液	氵
空 涳	氵
宛 涴	氵
函 涵	氵
垂 涶	氵
固 涸	氵
委 涹	氵
居 涺	氵
舍 涻	氵
京 凉	冫
昏 涽	氵
沓 涾	氵
豖 涿	氵
妾 淁	氵
寸 淂	氵 日 一
卷 淃	氵
甾 淄	氵
析 淅	氵
肴 淆	氵
其 淇	氵
屈 淈	氵
果 淉	氵
臽 淊	氵
林 淋	氵
尚 淌	氵
周 淍	氵
奉 淎	氵
昊 淏	氵
昌 淐	氵
叔 淑	氵
妻 凄	冫
芳 淓	氵
直 淔	氵
坴 淕	氵
卓 淖	氵
匊 淗	氵
匋 淘	氵
目 泪	氵
制 淛	氵
朋 淜	氵
肥 淝	氵
松 淞	氵
典 淟	氵
畀 淠	氵
炎 淡	氵
或 淢	氵
兒 淣	氵
於 淤	氵
录 渌	氵
金 淦	氵
宓 淧	氵
争 净	冫
夌 淩	氵
仑 沦	氵
壬 淫	氵 爫
卒 淬	氵
木 淭	户
隹 淮	氵
育 淯	氵
念 淰	氵
罙 深	氵
虎 淲	氵
享 淳	氵
忽 淴	氵
爿 渊	氵 片 一
来 涞	氵
昆 混	氵
青 清	氵
奄 淹	氵
戋 浅	氵
忝 添	氵
水 淼	水 水
芷 淽	氵
水 淾	金
帛 淿	氵
奔 渀	氵
水 渁	氵
旻 渂	氵
若 渃	氵
非 渄	氵
青 清	氵
刂 渆	氵 并
匕 渇	氵 日 勹
齐 济	氵
步 涉	氵
卑 渒	氵
刂 渕	氵 关
柔 渘	氵
奂 涣	氵
者 渚	氵
咸 减	冫
耎 渜	氵
俞 渝	氵
首 渞	氵
亭 渟	氵
木 渠	洰
度 渡	氵
风 沨	氵
查 渣	氵
勃 渤	氵
屋 渥	氵
呙 涡	氵
帝 渧	氵
畏 渨	氵
禹 渪	氵
枼 渫	氵
则 测	氵
胃 渭	氵
荷 渮	氵
巷 港	氵
弇 渰	氵
虹 渱	氵
宣 渲	氵
弭 渳	氵
曷 渴	氵
苗 渵	氵
英 渶	氵
兗 渷	氵
斿 游	氵
訇 渹	氵
少 渺	氵 目
省 渻	氵
美 渼	氵
哉 渽	氵
军 浑	氵
奈 渿	氵
癸 湀	氵
拾 湁	氵
咢 湂	氵
拜 湃	氵
眉 湄	氵
柬 湅	氵
音 湆	氵
肉 湇	氵 立
某 湈	氵
恬 湉	氵
奏 凑	冫
食 湌	氵
耑 湍	氵
面 湎	氵
柏 湐	氵
胥 湑	氵
咠 湒	氵
盆 湓	氵
前 湔	氵
建 湕	氵
胡 湖	氵
封 湗	氵
相 湘	氵
奕 湙	氵
胤 湚	氵
甚 湛	氵
是 湜	氵
皆 湝	氵
贞 浈	氵
皇 湟	氵
炭 湠	氵
禺 湡	氵
畐 湢	氵
昬 湣	氵
施 湤	氵
突 湥	氵
星 湦	氵
甬 涌	氵
狊 湨	氵
重 湩	氵
秋 湫	氵
水 湬	秋
垔 湮	氵
丿 汤	氵 弓 丿
生 湰	氵 夂 一
砉 湱	氵
爰 湲	氵
南 湳	氵
並 湴	氵
羑 湵	氵
泉 湶	氵
春 湷	氵
亮 湸	氵
厘 湹	氵
保 湺	氵
亯 湻	氵
工 湼	氵 臼
一 湽	氵 甾
两 满	氵 艸
叙 溆	氵
为 沩	氵
既 溉	氵
发 泼	氵
桂 溎	氵
唐 溏	氵
原 源	氵
袁 溒	氵
兼 溓	氵
羔 溔	氵
冡 溕	氵
隹 准	冫
乘 溗	氵
盍 溘	氵
泰 溙	氵
荅 溚	氵
窊 溛	氵
留 溜	氵
勾 沟	氵
蚤 溞	氵
冥 溟	氵
差 溠	氵
益 溢	氵
尃 溥	氵
攵 溦	氵 山 兀
栗 溧	氵
栽 溨	氵
奚 溪	氵
昷 温	氵
羗 溬	氵
畟 溭	氵
师 浉	氵
朔 溯	氵
秦 溱	氵
叟 溲	氵
员 涢	氵
臭 溴	氵
殷 溵	氵
容 溶	氵
圂 溷	氵
素 溸	氵
索 溹	氵
弱 溺	氵
羽 溻	氵 日
显 湿	氵
辱 溽	氵
鬼 溾	氵
畔 溿	氵
畜 滀	氵
除 滁	氵
旁 滂	氵
翁 滃	氵
仓 沧	氵
火 灭	一
鬲 滆	氵
真 滇	氵
高 滈	氵
晃 滉	氵
兹 滋	氵
条 涤	氵
蚩 滍	氵
水 荥	艸 冖
釜 滏	氵
骨 滑	氵
哥 滒	氵
宰 滓	氵
舀 滔	氵
水 滕	氵 丷 夫
衰 滖	氵
口 滘	氵 冖 八 工
匚 汇	氵
缶 滛	氵 爫
皋 滜	氵
龙 泷	氵
唇 滣	氵
脩 滫	氵
户 沪	氵
彪 滮	氵
带 滞	氵
竟 滰	氵
寇 滱	氵
参 渗	氵
商 滳	氵
啇 滴	氵
密 滵	氵
敖 滶	氵
乂 卤	卜 囗
许 浒	氵
虖 滹	氵
悠 滺	氵
产 浐	氵
梵 滼	氵
庸 滽	氵
衮 滚	氵
两 满	氵 艹
水 漀	殸
鱼 渔	氵
票 漂	氵
寂 漃	氵
崖 漄	氵
巢 漅	氵
桼 漆	氵
徙 漇	氵
祭 漈	氵
鹿 漉	氵
娄 溇	氵
隆 漋	氵
堇 漌	氵
從 漎	氵
屚 漏	氵
既 溉	氵
离 漓	氵
寅 演	氵
曹 漕	氵
教 漖	氵
悤 漗	氵
脣 漘	氵
区 沤	氵
水 漛	氵 丷 夫
埜 漜	氵
習 漝	氵
堂 漟	氵
莫 漠	氵
又 汉	氵
连 涟	氵
婪 漤	氵
圭 漥	氵 穴
水 漦	未 攵 厂
乾 漧	氵
逢 漨	氵
旋 漩	氵
奇 漪	氵 犭
曼 漫	氵
责 渍	氵
莽 漭	氵
康 漮	氵
累 漯	氵
崩 漰	氵
欶 漱	氵
张 涨	氵
章 漳	氵
崇 漴	氵
敘 漵	氵
患 漶	氵
郭 漷	氵
斩 渐	氵
焉 漹	氵
爽 漺	氵
翏 漻	氵
崔 漼	氵
犀 漽	氵
羕 漾	氵
水 浆	丬 夕
眾 潀	氵
页 颍	匕 水
並 潂	氵 山
肉 潃	氵 彳 攵
敕 潄	氵
雚 灌	氵
敍 潊	氵
窒 潌	氵
敝 潎	氵
矞 潏	氵
焦 潐	氵
发 泼	氵
象 潒	氵
惠 潓	氵
吉 洁	氵
琶 潖	氵
集 潗	氵
番 潘	氵
为 沩	氵
替 潜	氵
翕 潝	氵
路 潞	氵
灬 潟	氵 臼 勹
巽 潠	氵
敦 潡	氵
黄 潢	氵
闰 润	氵
粟 潥	氵
尞 潦	氵
曾 潧	氵
衆 潨	氵
異 潩	氵
智 潪	氵
絭 潫	氵
覃 潭	氵
朝 潮	氵
寻 浔	氵
贵 溃	氵
稍 潲	氵
屠 潳	氵
散 潵	氵
黑 潶	氵
笔 滗	氵
月 潸	氵 木 木
森 潹	氵
孱 潺	氵
黍 潻	氵
童 潼	氵
普 潽	氵
粦 潾	氵
围 涠	氵
止 涩	氵 刃
歮 澁	氵
徴 澂	氵 彳 山 一 王 攵
登 澄	氵
尧 浇	氵
劳 涝	氵
攵 澈	氵 育
敢 澉	氵
尊 澊	氵
景 澋	氵
斯 澌	氵
尌 澍	氵
彭 澎	氵
喦 澏	氵
云 沄	氵
畱 澑	氵
復 澓	氵
皓 澔	氵
间 涧	氵
日 澘	氵 林
舃 澙	氵
虞 澞	氵
黾 渑	氵
木 澡	氵 品
幹 澣	氵
丨 泽	氵 又 二
解 澥	氵
预 滪	氵
豊 澧	氵
筮 澨	氵
水 泶	小 冖
零 澪	氵
雍 澭	氵
会 浍	氵
粲 澯	氵
定 淀	氵
奥 澳	氵
睘 澴	氵
新 澵	氵
亶 澶	氵
方 澷	氵 曰 罒
感 澸	氵
詹 澹	氵
意 澺	氵
遂 澻	氵
辟 澼	氵
豦 澽	氵
禁 澿	氵
敫 激	氵
虫 浊	氵
廉 濂	氵
脓 浓	氵 农
又 濅	氵 宀 帚
戢 濈	氵
睢 濉	氵
楚 濋	氵
沓 濌	重
葱 濍	氵
鼎 濎	氵
暑 濐	氵
亷 濓	氵
尔 沵	氵
显 湿	氵
署 濖	氵
幕 濗	氵
宁 泞	氵
荣 溁	氵
冡 蒙	艸
尽 浕	氵
綦 濝	氵
鼻 濞	氵
齐 济	氵
豪 濠	氵
需 濡	氵
翠 濢	氵
斡 濣	氵
寿 涛	氵
夤 濥	氵
慈 濨	氵
蒦 濩	氵
靘 濪	氵
监 滥	氵
睿 濬	氵
蓋 濭	氵
翟 濯	氵
维 潍	氵
宾 滨	氵
穀 濲	氵
替 潜	氵
贱 溅	氵
乐 泺	氵
虑 滤	氵
尤 沋	氵
養 瀁	氵
莹 滢	氵
卖 渎	氵
写 泻	氵
冘 沈	氵
审 渖	氵
麃 瀌	氵
廛 瀍	氵
蔑 瀎	氵
刂 浏	氵 文
韯 瀐	氵
暴 瀑	氵
徵 瀓	氵
频 濒	氵
霍 瀖	氵
卢 泸	氵
翰 瀚	氵
嬴 瀛	氵
融 瀜	氵
历 沥	氵
静 瀞	氵
肃 潇	氵
萦 潆	氵
韰 瀣	氵
褱 瀤	氵
翯 瀥	氵
猪 潴	氵
龙 泷	氵
赖 濑	氵
泉 瀪	敏
縠 瀫	氵
尔 弥	弓
罽 瀱	氵
敛 潋	氵
薦 瀳	氵
糞 瀵	氵
翼 瀷	氵
韱 瀸	氵
龠 瀹	氵
毚 瀺	氵
戴 瀻	氵
襄 瀼	氵
蹇 瀽	氵
阑 澜	氵
繁 瀿	氵
霜 灀	氵
爵 灂	氵
豐 灃	氵
聂 滠	氵
壘 灅	氵
瞿 灈	氵
雝 灉	氵
鬵 灊	氵
雚 灌	氵
艳 滟	氵
西 洒	氵
艳 滟	氵
靡 灖	氵
蟺 灗	氵
难 滩	氵
颢 灏	氵
霸 灞	氵
囊 灢	氵
弯 湾	氵
栾 滦	氵
泉 灥	泉 泉
艳 滟	氵
豔 灩	氵
人 火	丷
丶 灬	丶 丶 丶
儿 灮	火
火 灰	一 丿
刀 灱	火
刂 灲	火
工 灴	火
土 灶	火
廾 灷	火
火 灸	久
乇 灹	火
也 灺	火
火 灻	土
勺 灼	火
火 灾	宀
灬 炁	旡
公 炂	火
火 炃	分
丑 炄	火
火 炅	日
文 炆	火
攵 炇	火
殳 炈	火
欠 炊	火
不 炋	火
介 炌	火
反 炍	火
火 炎	火
火 炏	火
丰 炐	火
木 炑	火
少 炒	火
斗 炓	火
夬 炔	火
亢 炕	火
火 炗	廿
斤 炘	火
火 炙	月
化 炛	火
旦 炟	火
甲 炠	火
正 炡	火
术 炢	火
可 炣	火
召 炤	火
弗 炥	火
犮 炦	火
也 炧	火 丿 一
它 炨	火
令 炩	火
出 炪	火
玄 炫	火
巨 炬	火
火 炭	山 厂
包 炮	火
冋 炯	火
灬 炰	包
火 炱	台
台 炲	火
丙 炳	火
央 炴	火
冬 炵	火
占 炶	火
主 炷	火
乍 炸	火
丶 为	丶 丿 ㇆
石 炻	火
兄 炾	火
乎 烀	火
交 烄	火
血 烅	火
行 烆	火
全 烇	火
灬 烈	列
火 烉	刀 冂 八
羊 烊	火
灬 烋	休
休 烌	火
先 烍	火
火 烎	开
一 乌	勹 ㇉
舟 烐	火
兆 烑	火
式 烒	火
圭 烓	火
同 烔	火
火 烕	戊 一
火 烖	土 戈
亥 烗	火
共 烘	火
各 烙	火
合 烚	火
亘 烜	火
灬 烝	丞
朴 烞	火
有 烠	火
共 烡	火
宅 烢	火
灰 烣	火
考 烤	火
希 烯	火
孚 烰	火
冏 烱	火
火 烲	折
甫 烳	火
圣 烃	火
勺 烵	火
廷 烶	火
完 烷	火
每 烸	火
灬 烹	亨
良 烺	火
延 烻	火
豕 烼	火
夆 烽	火
土 烾	炎
彤 烿	火
谷 焀	火
火 焂	攸
赤 焃	火
灬 焄	君
告 焅	火
肙 焆	火
肖 焇	火
已 焈	户
灬 焉	正 一 勹
旱 焊	火
夋 焌	火
弟 焍	火
灬 焎	折
灬 焏	了 口 又
吾 焐	火
含 焓	火
臽 焰	火
局 焗	火
咅 焙	火
火 焚	林
昆 焜	火
昏 焝	火
享 焞	火
昔 焟	火
卒 焠	火
尢 无	一
空 焢	火
灬 焣	取
火 焤	府
宛 焥	火
灬 焦	隹
忩 焧	火
冐 焨	火
朋 焩	火
穹 焪	火
芮 焫	火
易 焬	火
欣 焮	火
卓 焯	火
臽 焰	火
火 焱	火 火
夜 焲	火
隹 焳	火
育 焴	火
岡 焵	火
灬 然	月 犬
卑 焷	火
火 焸	日 日
昇 焺	火
昌 焻	火
尧 烧	火
甚 煁	火
革 煂	火
奎 煃	火
重 煄	火
段 煅	火
叚 煆	火
一 炼	火 东
宣 煊	火
星 煋	火
皇 煌	火
秋 煍	火
灬 煎	前
畐 煏	火
英 煐	火
火 煑	者
韦 炜	火
耑 煓	火
占 煔	炎
灬 煕	巸
爰 煖	火
耎 煗	火
咸 煘	火
因 烟	火
火 煚	昛
火 煛	目 目
立 煜	火 日
眉 煝	火
灬 煞	刍 攵
胃 煟	火
枼 煠	火
建 煡	火
卂 茕	艸 冖
柔 煣	火
某 煤	火
奂 焕	火
灬 煦	昫
灬 照	日 召
畏 煨	火
页 烦	火
酋 煪	火
豕 煫	火 丷
丿 炀	火 弓 丿
灬 煭	巛 列
灬 煮	者
品 煰	火
火 煲	保
胡 煳	火
南 煵	火
扁 煸	火
冓 煹	火
退 煺	火
唐 煻	火
芻 煼	火
扇 煽	火
恩 煾	火
尃 煿	火
晃 熀	火
脅 熁	火
息 熄	火
昷 煴	火
盍 熆	火
高 熇	火
熙 熈	丿
灬 熊	能
火 熋	能
缶 熎	爫
火 熏	丿 一 里 丷
冥 熐	火
兼 熑	火
火 荧	艸 冖
烏 熓	火
容 熔	火
仓 炝	火
留 熘	火
灬 熙	巸
票 熛	火
悤 熜	火
鹿 熝	火
堅 熞	火
灬 熟	孰
習 熠	火
逢 熢	火
崔 熣	火
翌 熤	火
通 熥	火
雀 熦	火
火 熨	尉
扈 熩	火
移 熪	火
庶 熫	火
火 熬	敖
火 熭	彗
翏 熮	火
大 熯	火 革
灬 热	执
页 颎	匕 火
曼 熳	火
商 熵	火
最 熶	火
曾 熷	火
朁 熸	火
灬 熹	喜
喜 熺	火
翕 熻	火
異 熼	火
只 炽	火
黄 熿	火
华 烨	火
覃 燂	火
然 燃	火
炎 燄	臽
炎 燅	埶
尊 燇	火
丁 灯	火
屯 炖	火
木 燊	火 火 火
焦 燋	火
斯 燍	火
尞 燎	火
矞 燏	火
粦 燐	火
童 燑	火
尧 烧	火
火 燓	木 爻 木
番 燔	火
灬 燕	廿 北 口
火 烫	汤
火 燚	火 火 火
火 燛	臦
闷 焖	火
吕 营	艹 冖
禀 燷	火
喿 燥	火
山 灿	火
遂 燧	火
敫 燩	火
葱 燪	火
廉 燫	火
殳 毀	臼 土
虫 烛	火
又 燮	火 言 火
零 燯	火
意 燱	火
照 燳	火
会 烩	火
需 燸	火
火 燹	豕 豕
槀 燺	火
熏 燻	火
尽 烬	火
壽 燽	火
灬 焘	寿
翟 燿	火
赫 爀	火
火 爂	臼 同 冖
墨 爅	火
暴 爆	火
麃 爊	火
勳 爋	火
乐 烁	火
户 炉	火
蕉 爑	火
尞 爒	炙
羲 爔	火
火 爕	火 言 火
曅 爗	火
襄 爙	火
龠 爚	火 火
兰 烂	火
爵 爝	火
虫 爞	火 虫 虫
雚 爟	火
蠆 爡	火
灬 爢	靡
火 爨	臼 同 冖 林 大
乀 爪	厂 丨
丶 爫	丿 丶 丶
巴 爬	爪
爭 争	爫 彐 亅
包 爮	爪
冉 爯	爫
友 爰	爫 一
丶 为	丶 丿 ㇆
爪 爴	國
爭 爵	爫 肀
乂 父	八
巴 爸	父
多 爹	父
卩 爷	父
乂 爻	乂
且 爼	爻
乂 爽	大 乂 乂 乂
八 尔	丿 乛 亅
丿 爿	丨 一 丨 一
木 床	广
可 牁	爿
羊 牂	爿
枼 牃	爿
庸 牅	爿
啬 墙	土
㇆ 片	丄 丿
反 版	片
半 牉	片
召 牊	片
卑 牌	片
怱 牎	片
俞 牏	片
臿 牐	片
扁 牑	片
枼 牒	片
旁 牓	片
尃 牔	片
悤 牕	片
甫 牖	片 戶
卖 牍	片
丿 牙	丅 一 亅
牙 牚	尚
十 牛	丿 一
丿 牜	丿 十
匕 牝	牜
力 牞	牜
牛 牟	厶
也 牠	牜
土 牡	牜
牛 牢	宀
刃 牣	牜
亡 牤	牜
方 牥	牜
攵 牧	牜
亢 牨	牜
勿 物	牜
牛 牪	牛
戈 牫	牜
丿 牬	牜 丿 ㇉ 丨
四 牭	牜
牛 牮	代
古 牯	牜
由 牰	牜
可 牱	牜
生 牲	牜
母 牳	牜
氐 牴	牜
牛 牶	𠔉
全 牷	牜
字 牸	牜
寺 特	牜
尨 牻	牜
牛 牵	大 冖
吾 牾	牜
告 牿	牜
牛 犀	尸 二 丨 二
牛 犁	利
牛 犂	禾 丿 刀
咅 犃	牜
奇 犄	牜
直 犆	牜
牛 犇	牛 牛
卷 犈	牜
享 犉	牜
具 犋	牜
叚 犌	牜
建 犍	牜
牛 犎	封
扁 犏	牜
科 犐	牜
狊 犑	牜
高 犒	牜
芻 犓	牜
用 犕	牜 艹 厂
牛 荦	艸 冖
害 犗	牜
牛 犘	麻
牛 犚	尉
牛 犛	未 攵 厂
敦 犜	牜
童 犝	牜
牛 犟	强
卖 犊	牜
巤 犣	牜
麃 犥	牜
暴 犦	牜
西 牺	牜
牛 犨	隹 隹
牛 犩	魏
夔 犪	牜
牛 犫	隹 言 隹
丶 犬	大
丿 犭	丶 亅
乂 犮	一 丿 丶
卩 犯	犭
九 犰	犭
丸 犱	犭
才 犲	犭
勺 犳	犭
干 犴	犭
乞 犵	犭
亢 犺	犭
巿 犻	犭
孔 犼	犭
牙 犽	犭
犬 犾	犭
卞 犿	犭
犬 状	丬
允 狁	犭
王 狂	犭
丑 狃	犭
火 狄	犭
壬 狅	犭
中 狆	犭
木 狇	犭
丕 狉	犭
犬 狊	目
示 狋	犭
生 狌	犭
包 狍	犭
甲 狎	犭
也 狏	犭 丿 一
瓜 狐	犭
令 狑	犭
弗 狒	犭
皮 狓	犭
尼 狔	犭
幼 狕	犭
穴 狖	犭
句 狗	犭
戉 狘	犭
且 狙	犭
旦 狚	犭
白 狛	犭
古 狜	犭
亘 狟	犭
艮 狠	犭
交 狡	犭
各 狢	犭
兆 狣	犭
吉 狤	犭
旬 狥	犭
一 狦	犭 冊
舌 狧	犭
戎 狨	犭
守 狩	犭
同 狪	犭
老 狫	犭
余 狳	犭
土 狴	犭 比
尨 狵	犭
希 狶	犭
肙 狷	犭
里 狸	犭
夹 狭	犭
言 狺	犭
夋 狻	犭
良 狼	犭
贝 狈	犭
折 狾	犭
延 狿	犭
沙 猀	犭
利 猁	犭
旱 猂	犭
京 猄	犭
非 猅	犭
犬 猆	非
虎 猇	犭
卑 猈	犭
其 猉	犭
兒 猊	犭
犬 猋	犬 犬
肩 猏	犭
羌 猐	犭
昆 猑	犭
犬 猒	日 肉
果 猓	犭
宗 猔	犭
昌 猖	犭
奇 猗	犭
制 猘	犭
争 狰	犭
隹 猚	犭
孟 猛	犭
靑 猜	犭
卒 猝	犭
舍 猞	犭
胡 猢	犭
夕 猣	犭 凶 八
癸 猤	犭
畏 猥	犭
爰 猨	犭
星 猩	犭
彖 猭	犭
耑 猯	犭
契 猰	犭
柔 猱	犭
葛 猲	犭
叚 猳	犭
侯 猴	犭
扁 猵	犭
尤 犹	犭
犬 猷	酋
眉 猸	犭
查 猹	犭
孙 狲	犭
尃 猼	犭
冥 猽	犭
骨 猾	犭
袁 猿	犭
叟 獀	犭
马 犸	犭
原 獂	犭
木 呆	口
犬 狱	犭 讠
师 狮	犭
皋 獆	犭
益 獈	犭
秦 獉	犭
臯 獋	犭
曼 獌	犭
竟 獍	犭
大 奖	丬 夕
章 獐	犭
犬 獒	敖
敖 獓	犭
皐 獔	犭
崔 獕	犭
厥 獗	犭
犬 獘	敝
敝 獙	犭
獚
菐 獛	犭
粦 獜	犭
矞 獝	犭
童 獞	犭
尞 獠	犭
舄 獡	犭
敫 獥	犭
葛 獦	犭
睘 獧	犭
虫 独	犭
会 狯	犭
佥 猃	犭
解 獬	犭
尔 狝	犭
熏 獯	犭
宁 狞	犭
犬 获	艸 犭
需 獳	犭
蒙 獴	犭
昔 猎	犭
广 犷	犭
口 兽	丷 田 一
赖 獭	犭
犬 献	南
弥 猕	犭
襄 獽	犭
夒 獿	犭
罗 猡	犭
矍 玃	犭
幺 玄	亠
少 玅	玄
玄 玆	玄
十 率	玄 冫 丶 丶
氏 玈	玄 丿 一
丶 玉	王
丶 玊	王
一 王	一 一 丨
乚 玌	王
一 玍	午
丁 玎	王
力 玏	王
八 玐	王
工 玒	王
勺 玓	王
川 玔	王
干 玕	王
久 玖	王
于 玗	王
己 玘	王
公 玜	王
午 玝	王
夫 玞	王
文 玟	王
介 玠	王
牙 玡	王
分 玢	王
卞 玣	王
丰 玤	王
月 玥	王
夬 玦	王
允 玧	王
王 玨	王
元 玩	王
今 玪	王
攵 玫	王
丹 玬	王
比 玭	王
令 玲	王
代 玳	王
世 玴	王
甘 玵	王
平 玶	王
占 玷	王
包 玸	王
玄 玹	王
皮 玻	王
此 玼	王
句 玽	王
甲 玾	王
召 玿	王
白 珀	王
瓦 珁	王
可 珂	王
冉 珃	王
生 珄	王
申 珅	王
台 珆	王
且 珇	王
加 珈	王
民 珉	王
卯 珋	王
必 珌	王
彡 珍	王 人
尓 珎	王
玉 珏	王
聿 珒	王
交 珓	王
存 珔	王
劦 珕	王
光 珖	王
先 珗	王
舟 珘	王
共 珙	王
因 珚	王
有 珛	王
羊 珜	王
羽 珝	王
各 珞	王
夙 珟	王
朱 珠	王
人 珡	王 王
艮 珢	王
旬 珣	王
缶 珤	王
耳 珥	王
向 珦	王
兆 珧	王
合 珨	王
行 珩	王
圭 珪	王
充 珫	王
戌 珬	王
王 班	玉 刂
帀 珮	玉 几
彣 珳	王
我 珴	王
呈 珵	王
弟 珶	王
武 珷	王
吾 珸	王
成 珹	王
君 珺	王
每 珻	王
廷 珽	王
见 现	王
足 珿	王
含 琀	王
疋 琁	王 丿 一
言 琂	王
求 球	王
肙 琄	王
里 理	王
秀 琇	王
孚 琈	王
川 琉	王 亠 厶
邪 琊	王
希 琋	王
岑 琌	王
利 琍	王
完 琓	王
定 琔	王
卑 琕	王
卒 琗	王
昏 琘	王
或 琙	王
居 琚	王
罙 琛	王
旻 琝	王
玉 琞	明
隹 琟	王
典 琠	王
叔 琡	王
豖 琢	王
咅 琣	王
爭 琤	王
虎 琥	王
奇 琦	王
昆 琨	王
昌 琩	王
其 琪	王
奉 琫	王
宛 琬	王
彔 琭	王
宗 琮	王
官 琯	王
炎 琰	王
周 琱	王
非 琲	王
林 琳	王
今 琴	王 王
比 琵	王
巴 琶	王
羌 琷	王
卓 琸	王
木 琹	王 王
琺 珐	王 法
者 琽	王
界 琾	王
军 珲	王
禹 瑀	王
冒 瑁	王
眉 瑂	王
宣 瑄	王
是 瑅	王
星 瑆	王
毒 瑇	王
柔 瑈	王
昬 瑉	王
咸 瑊	王
韦 玮	王
耎 瑌	王
皆 瑎	王
穿 瑏	王
前 瑐	王
彖 瑑	王
丿 玚	王 弓 丿
柬 瑓	王
泉 瑔	王
叚 瑕	玉
段 瑖	王
爰 瑗	王
耶 瑘	王
囟 瑙	王 巛
胡 瑚	王
英 瑛	王
俞 瑜	王
皇 瑝	王
耑 瑞	王
必 瑟	王
留 瑠	王
容 瑢	王
贝 琐	王 小
缶 瑶	王 爫
昷 瑥	王
秦 瑧	王
晉 瑨	王
玉 莹	艹 冖
马 玛	王
舀 瑫	王
玉 瑬	流
唐 瑭	王
栗 瑮	王
良 琅	王
鬼 瑰	王
真 瑱	王
仓 玱	王
差 瑳	王
殳 瑴	士 冖 一 王
蚤 瑵	王
荼 瑹	王
常 瑺	王
堇 瑾	王
玉 瑿	殹
崔 璀	王
悤 璁	王
基 璂	王
离 璃	王
竟 璄	王
巢 璅	王
翏 璆	王
旋 璇	王
敖 璈	王
连 琏	王
章 璋	王
寅 璌	王
彘 璏	王
路 璐	王
登 璒	王
曾 璔	王
渠 璖	王
粦 璘	王
尞 璙	王
矞 璚	王
璜
菐 璞	王
景 璟	王
番 璠	王
进 琎	王
畱 璢	王
几 玑	王
敬 璥	王
爱 瑷	王
玉 璧	辟
粲 璨	王
豦 璩	王
喿 璪	王
当 珰	王
敫 璬	王
亶 璮	王
不 环	王
瑟 璱	王
遂 璲	王
与 玙	王
敷 璷	王
宾 瑸	王
翠 璻	王
玉 玺	尔
睿 璿	王
需 瓀	王
蒦 瓁	王
畾 瓃	王
黎 瓈	王
京 琼	王
褱 瓌	王
龙 珑	王
婴 璎	王
襄 瓖	王
巂 瓗	王
雚 瓘	王
赞 瓒	王
獻 瓛	王
丶 瓜	爪 一
勺 瓝	瓜
失 瓞	瓜
包 瓟	瓜
瓜 瓠	夸
瓜 瓡	幸
瓜 瓢	票
辛 瓣	辛 瓜
瓜 瓤	襄
虫 瓥	瓜 豕 虫
瓦 瓨	工
反 瓪	瓦
瓦 瓫	分
瓦 瓬	方
瓦 瓭	冘
瓦 瓮	公
瓦 瓳	古
瓦 瓴	令
瓦 瓵	台
瓦 瓶	并
瓦 瓷	次
瓦 瓹	肙
瓦 瓺	镸
瓦 瓻	希
瓦 瓽	尚
瓦 瓾	委
瓦 瓿	咅
瓦 甀	垂
瓦 瓶	并
瓦 甂	扁
瓦 甃	秋
瓦 甄	垔
瓦 甆	兹
瓦 甈	臬
瓦 甉	兼
瓦 甋	啇
瓦 瓯	区
瓦 甍	艸 网 冖
瓦 甏	彭
瓦 甐	粦
瓦 甑	曾
瓦 甓	辟
瓦 甔	詹
瓦 甕	雍
瓦 甗	虍 鬲
一 甘	廿
弋 甙	甘
乚 甚	其
舌 甛	甘
甘 甜	舌
甘 甝	虎
甘 甞	尚
丨 生	丿 三
生 甠	日
生 甡	生
丿 产	立
丿 产	立
生 甤	豕
男 甥	生
生 甦	更
月 甧	生 生
一 用	冂 十
乚 甩	月
用 甪	丶
用 甫	一 丶
用 甬	龴
用 甭	不
用 甮	勿
丁 宁	宀
十 田	囗
十 由	囗
十 甲	囗
十 申	囗
丄 甴	口
田 甶	丶
力 男	田
田 甸	勹
丂 甹	由
丁 町	田
丁 甼	田
川 甽	田
田 甾	巛
亡 甿	田
丌 畀	田
丌 畁	由
久 畂	田
勺 畃	申
田 留	卯
厶 畆	亩
匀 畇	田
反 畈	田
夫 畉	田
井 畊	田
攵 畋	田
介 界	田
介 畍	田
犬 畎	田
田 畐	一 口
田 畑	火
人 畒	亩
半 畔	田
田 畕	田
瓜 畖	田
田 畗	丶 畐
冉 畘	田
田 留	卯
田 畚	厶 大
彡 畛	田 人
田 畜	玄
田 亩	亠
久 畞	十 田
夂 畟	田 八
亥 畡	田
十 毕	比
畐 畣	人
寺 畤	田
各 略	田
土 畦	田 土
各 畧	田
田 畨	米
田 番	采
凵 画	一 由
田 畬	余
余 畭	田
母 畮	田
夋 畯	田
廾 异	己
田 畱	丣
田 畲	余
冝 畳	田
凵 画	一 由
彐 当	小
叕 畷	田
奇 畸	田
宛 畹	田
田 畺	三 田
土 畻	田 𠔉
重 畽	田
田 畾	田 田
田 畿	幾
疌 疀	甾
翏 疁	田
童 疃	田
粦 疄	田
畺 疅	田
畺 疆	弓 土
寿 畴	田
畐 疈	畐 丶 丿
彑 疉	畾 宀
冝 叠	叒
人 疋	乛 卜
人 疌	一 肀 卜
旦 疍	疋
束 疎	疋
巟 疏	疋
疋 疐	十 冖 田
疋 疑	匕 矢 龴
丬 疒	丶 一
乃 疓	疒
丁 疔	疒
匕 疕	疒
工 疘	疒
乞 疙	疒
久 疚	疒
寸 疛	疒
下 疜	疒
山 疝	疒
亏 疞	疒
火 疢	疒
尤 疣	疒
巴 疤	疒
介 疥	疒
夬 疦	疒
氏 疧	疒
牙 疨	疒
卆 疩	疒
必 疪	疒
殳 疫	疒
主 疰	疒
包 疱	疒
皮 疲	疒
甘 疳	疒
可 疴	疒
此 疵	疒
世 疶	疒
氐 疷	疒
旦 疸	疒
彡 疹	疒 人
乏 疺	疒
只 疻	疒
冬 疼	疒
且 疽	疒
矢 疾	疒
弗 疿	疒
句 痀	疒
占 痁	疒
加 痂	疒
玄 痃	疒
乍 痄	疒
丙 病	疒
尼 痆	疒
正 症	疒
全 痊	疒
虫 痋	疒
同 痌	疒
夷 痍	疒
亥 痎	疒
有 痏	疒
回 痐	疒
多 痑	疒
至 痓	疒
寺 痔	疒
艮 痕	疒
每 痗	疒
豆 痘	疒
圣 痉	疒
孝 痚	疒
甬 痛	疒
禿 痜	疒
尨 痝	疒
否 痞	疒
肖 痟	疒
夋 痠	疒
甫 痡	疒
利 痢	疒
志 痣	疒
坐 痤	疒
痥
吾 痦	疒
沙 痧	疒
又 痩	疒 申
易 痬	疒
朋 痭	疒
官 痯	疒
炎 痰	疒
非 痱	疒
林 麻	广
林 痳	疒
季 痵	疒
典 痶	疒
奄 痷	疒
制 痸	疒
畀 痹	疒
卑 痺	疒
昏 痻	疒
固 痼	疒
隹 痽	疒
阿 痾	疒
委 痿	疒
於 瘀	疒
卒 瘁	疒
亚 痖	疒
豖 瘃	疒
昔 瘄	疒
重 瘇	疒
契 瘈	疒
俞 瘉	疒
侯 瘊	疒
风 疯	疒
剌 瘌	疒
丿 疡	疒 弓 丿
甚 瘎	疒
者 瘏	疒
臾 瘐	疒
奂 痪	疒
苦 瘔	疒
叚 瘕	疒
音 瘖	疒
蚤 瘙	疒
欮 瘚	疒
恝 瘛	疒
息 瘜	疒
眔 瘝	疒
座 瘞	疒
昷 瘟	疒
脊 瘠	疒
仓 疮	疒
般 瘢	疒
鬼 瘣	疒
留 瘤	疒
差 瘥	疒
叟 瘦	疒
一 疟	疒 匸
真 瘨	疒
荅 瘩	疒
票 瘭	疒
参 瘆	疒
族 瘯	疒
累 瘰	疒
夹 瘗	疒
从 疭	疒
翏 瘳	疒
章 瘴	疒
祭 瘵	疒
欶 瘶	疒
敕 瘷	疒
肉 瘸	疒 加
屚 瘺	疒
娄 瘘	疒
莫 瘼	疒
堇 瘽	疒
癀
復 癁	疒
了 疗	疒
隆 癃	疒
焦 癄	疒
畱 癅	疒
劳 痨	疒
闲 痫	疒
单 瘅	疒
陰 癊	疒
山 癌	疒 品
斑 癍	疒
睘 癏	疒
心 愈	俞
微 癓	疒
意 癔	疒
雍 癕	疒
辟 癖	疒
雷 癗	疒
万 疠	疒
鼠 癙	疒
詹 癚	疒
禀 癝	疒
殿 癜	疒
仑 瘪	疒 自
知 痴	疒
羊 痒	疒
节 疖	疒
徵 癥	疒
历 疬	疒
霍 癨	疒
赖 癞	疒
鲜 癣	疒
婴 瘿	疒
隐 瘾	疒
瞿 癯	疒
用 痈	疒
难 瘫	疒
颠 癫	疒
纍 癳	疒
天 癸	癶
殳 癹	癶
丶 发	丿 一 丿 又
豆 登	癶
丶 发	丿 一 丿 又
日 白	丶
白 百	一
乚 癿	白
匕 皀	白
十 皁	白
七 皂	白
儿 皃	白
勺 的	白
巴 皅	白
白 皆	比
王 皇	白
反 皈	白
此 皉	白
令 皊	白
十 皋	白 大
末 皌	白
卩 皍	白 匕
交 皎	白
并 皏	白
二 皐	白 二 十
我 皒	白
告 皓	白
旱 皔	白
百 皕	百
完 皖	白
周 皗	白
青 皘	白
白 皙	析
岂 皑	白
白 皛	白 白
高 皜	白
光 皝	皇
皋 皞	白
崔 皠	白
皐 皡	白
堯 皢	白
番 皤	白
臯 皥	白
敫 皦	白
土 皨	皛
晃 皩	皇
麃 皫	白
霍 皬	白
爵 皭	白
支 皮	丿
干 皯	皮
包 皰	皮
皮 皳	求
皮 皴	夋
皮 皵	昔
皮 皶	查
皮 皷	十 豆
皮 皲	军
军 皲	皮
皮 皱	刍
皮 皻	虘
皮 皼	壹
皮 皽	亶
一 皿	冊
皿 盀	卜
皿 盁	乃
皿 盂	于
不 杯	木
皿 盄	弔
皿 盅	中
皿 盆	分
皿 盇	太
皿 盈	夃
皿 盉	禾
皿 益	丷 一 八
皿 盋	犮
皿 盌	夗
皿 盍	去
皿 盎	央
皿 盒	合
皿 盓	汙
皿 盔	灰
皿 盕	汎
皿 盙	甫
皿 盚	求
皿 盛	成
皿 盗	次
皿 盝	彔
皿 盏	戋
皿 盟	明
皿 盠	彖
冫 尽	尺
皿 盢	畎
皿 监	丨 丨 丿 一 丶
皿 盘	舟
皿 盥	臼 水
皿 盦	今 酉
尸 卢	卜
皿 盩	幸 攵
汤 荡	艸
皿 盫	合 酉
皿 盬	臣 丿 一 古
皿 盭	幺 幸 攵
二 目	囗
丁 盯	目
干 盰	目
于 盱	目
亡 盲	目
亡 盳	目
一 直	十 目 丨
乞 盵	目
元 盶	目
勺 盷	目
目 相	木
屯 盹	目
斤 盺	目
兮 盻	目
分 盼	目
丰 盽	目
目 盾	厂 十
文 盿	目
月 眀	目
目 省	少
氏 眂	目
云 眃	目
丏 眄	目
反 眅	目
方 眆	目
少 眇	目
冘 眈	目
目 眉	尸 丶
毛 眊	目
目 看	手
小 県	目 丨 一
示 眎	目
央 眏	目
正 眐	目
幼 眑	目
申 眒	目
戉 眓	目
八 眔	目 丨 八
彡 眕	目 人
兄 眖	目
句 眗	目
目 眘	大 丷
台 眙	目
目 眚	生
未 眛	目
末 眜	目
宁 眝	目
八 眞	匕 目 丨 一
八 真	直
民 眠	目
氐 眡	目
目 眢	夗
失 眣	目
尼 眤	目
目 眥	此
此 眦	目
召 眧	目
乏 眨	目
玄 眩	目
丙 眪	目
半 眫	目
圭 眭	目
同 眮	目
至 眰	目
夷 眱	目
耳 眲	目
名 眳	目
旬 眴	目
多 眵	目
匡 眶	目
目 眷	𠔉
牟 眸	目
关 眹	目
兆 眺	目
羊 眻	目
艮 眼	目
氏 眽	目 厂
人 众	人 人
永 眿	目
目 睂	仌 丨 厂
夋 睃	目
肖 睄	目
旱 睅	目
完 睆	目
弟 睇	目
呈 睈	目
坐 睉	目
肙 睊	目
我 睋	目
免 睌	目
見 睍	目
希 睎	目
木 困	囗
炎 睒	目
典 睓	目
宛 睕	目
夌 睖	目
易 睗	目
 睘	罒 一 口
戾 睙	目
厓 睚	目
青 睛	目
争 睁	目
来 睐	目
卒 睟	目
卷 睠	目
垂 睡	目
隹 睢	目
目 督	叔
畀 睤	目
卑 睥	目
土 睦	目 土 儿
昏 睧	目
兒 睨	目
彔 睩	目
幸 睪	罒
疌 睫	目
采 睬	目
周 睭	目
俞 睮	目
目 睯	敃
若 睰	目
叚 睱	目
星 睲	目
奎 睳	目
春 睶	目
建 睷	目
眉 睸	目
者 睹	目
侯 睺	目
宣 睻	目
是 睼	目
癸 睽	目
幸 睾	丶 罒
目 睿	卜 冖 一 八 人
目 瞀	敄
狊 瞁	目
犮 瞂	盾
盾 瞃	目
苗 瞄	目
秋 瞅	目
米 眯	目
翁 瞈	目
殳 瞉	士 冖 一 目
唐 瞊	目
真 瞋	目
皿 瞌	目 去
叟 瞍	目
害 瞎	目
袁 瞏	罒
目 瞐	目 目
冥 瞑	目
責 瞔	目
章 瞕	目
目 瞖	殹
区 眍	目
莫 瞙	目
寅 瞚	目
离 瞝	目
两 瞒	目 艹
票 瞟	目
堂 瞠	目
目 瞢	艸 网 冖
目 瞥	敝
喜 瞦	目
焦 瞧	目
菐 瞨	目
登 瞪	目
覃 瞫	目
舜 瞬	目
亅 了	乛
攵 瞮	目 育
敢 瞰	目
矞 瞲	目
童 瞳	目
粦 瞵	目
贵 瞆	目
葉 瞸	目
詹 瞻	目
佥 睑	目
目 瞽	鼓
空 瞾	目 目
隹 瞿	目 目
微 矀	目
愁 矁	目
喿 矂	目
熏 矄	目
翟 矅	目
蒦 矆	目
冡 蒙	艸
臱 矈	目
隻 矍	目 目
夐 矎	目
臱 矏	目
霍 矐	目
瞢 矒	目
龙 眬	目
雚 矔	目
直 矗	直 直
属 瞩	目
丿 矛	予
今 矜	矛
令 矝	矛
冏 矞	矛
肖 矟	矛
昔 矠	矛
矍 矡	矛
天 矢	丿
矢 矣	厶
矢 矤	弓
口 知	矢
矢 矦	厃
引 矧	矢
夭 矨	矢
巨 矩	矢
舟 矪	矢
坐 矬	矢
豆 短	矢
委 矮	矢
乔 矫	矢
曾 矰	矢
蒦 矱	矢
口 石	一 丿
丁 矴	石
刂 矵	石
子 矷	石
干 矸	石
兀 矹	石
乇 矺	石
乞 矻	石
工 矼	石
夕 矽	石
凡 矾	石
少 砂	石
丹 砃	石
夬 砄	石
水 砅	石
夫 砆	石
文 砇	石
厄 砈	石
石 砉	丰
亢 砊	石
止 砋	石
切 砌	石
欠 砍	石
介 砎	石
分 砏	石
及 砐	石
牙 砑	石
比 砒	石
殳 砓	石
开 研	石
卆 砕	石
屯 砘	石
瓦 砙	石
去 砝	石
末 砞	石
乍 砟	石
且 砠	石
玉 砡	石
可 砢	石
它 砣	石
也 砤	石 丿 一
氐 砥	石
石 砦	此
占 砧	石
戹 砨	石
弗 砩	石
母 砪	石
主 砫	石
立 砬	石
乏 砭	石
石 砮	奴
氷 砯	石
平 砰	石
令 砱	石
包 砲	石
石 砳	石
皮 破	石
本 砵	石
白 砶	石
申 砷	石
匝 砸	石
艾 砹	石
仝 砼	石
全 硂	石
朱 硃	石
光 硄	石
圭 硅	石
合 硆	石
囟 硇	石
吉 硈	石
聿 硉	石
危 硊	石
亥 硋	石
各 硌	石
艮 硍	石
刑 硎	石
幵 硏	石
同 硐	石
并 硑	石
西 硒	石
共 硔	石
圣 硁	石
肖 硝	石
告 硞	石
延 硟	石
良 硠	石
宏 硡	石
余 硢	石
孝 硣	石
夹 硖	石
尨 硥	石
弄 硦	石
甬 硧	石
车 砗	石
石 硩	折
我 硪	石
巟 硫	石
更 硬	石
芒 硭	石
见 砚	石
石 硰	沙
困 硱	石
谷 硲	石
岑 硶	石
岸 硸	石
松 硹	石
豖 硺	石
朋 硼	石
奄 硽	石
垂 硾	石
空 硿	石
其 棋	木
宗 碂	石
青 碃	石
林 碄	石
囷 碅	石
石 碆	波
定 碇	石
昏 碈	石
周 碉	石
岢 碋	石
录 碌	石
卒 碎	石
昔 碏	石
夌 碐	石
卑 碑	石
金 碒	石
隹 碓	石
武 碔	石
奇 碕	石
宛 碗	石
典 碘	石
咅 碚	石
耎 碝	石
石 碞	品
木 碟	石 世
亭 碠	石
毒 碡	石
曷 碣	石
英 碤	石
扁 碥	石
客 碦	石
石 碧	王 白
畏 碨	石
页 硕	石
甚 碪	石
段 碫	石
叚 碬	石
丿 砀	石 弓 丿
是 碮	石
並 碰	石
咸 碱	石
帝 碲	石
炭 碳	石
查 碴	石
契 碶	石
风 砜	石
宣 碹	石
角 确	石
高 碻	石
马 码	石
展 碾	石
屑 碿	石
逆 磀	石
兹 磁	石
留 磂	石
虒 磃	石
唐 磄	石
旁 磅	石
骨 磆	石
比 磇	石 囟
鬼 磈	石
桑 磉	石
石 磊	石 石
差 磋	石
真 磌	石
害 磍	石
奚 磎	石
兼 磏	石
石 磐	般
岂 硙	石
追 磓	石
桀 磔	石
皿 磕	石 去
習 磖	石
缶 磘	石 爫
衮 磙	石
专 砖	石
祭 磜	石
敖 磝	石
崩 磞	石
翏 磟	石
卤 硵	石
力 磡	石 甚
爽 磢	石
参 碜	石
殷 磤	石
累 磥	石
票 磦	石
责 碛	石
石 磨	麻
戚 磩	石
崔 磪	石
石 磬	殸
脣 磭	石
几 矶	石
善 磰	石
渠 磲	石
曾 磳	石
登 磴	石
舄 磶	石
粦 磷	石
奠 磸	石
覃 磹	石
黄 磺	石
番 磻	石
集 磼	石
尧 硗	石
石 磿	厤
焦 礁	石
掌 礃	石
乔 硚	石
敦 礅	石
佥 硷	石
奧 礇	石
遂 礈	石
敫 礉	石
石 礊	車 凵 殳
雷 礌	石
葛 礍	石
出 础	石
畺 礓	石
辟 礔	石
石 礕	辟
㝵 碍	石
需 礝	石
蒙 礞	石
包 炮	火
慈 礠	石
蒪 礡	石
蔑 礣	石
蔡 礤	石
广 矿	石
畾 礧	石
石 礨	畾
厉 砺	石
乐 砾	石
石 礬	木 爻 木 大
霍 礭	石
包 砲	石
石 砻	龙
磨 礳	石
薄 礴	石
霜 礵	石
雚 礶	石
小 示	二
丶 礻	丶 乙 丨
乃 礽	礻
土 社	礻
勺 礿	礻
巳 祀	礻
阝 祁	礻
也 祂	礻
介 祄	礻
夭 祅	礻
天 祆	礻
氏 祇	礻
斤 祈	礻
止 祉	礻
方 祊	礻
殳 祋	礻
中 祌	礻
石 祏	礻
右 祐	礻
失 祑	礻
召 祒	礻
犮 祓	礻
付 祔	礻
必 祕	礻
且 祖	礻
氐 祗	礻
示 祘	示
未 祙	礻
乍 祚	礻
去 祛	礻
古 祜	礻
兄 祝	礻
申 神	礻
示 祟	出
司 祠	礻
示 祡	此
氏 祣	礻 丿 一
羽 祤	礻
羊 祥	礻
吴 祦	礻
兆 祧	礻
示 票	襾
朱 祩	礻
危 祪	礻
合 祫	礻
至 祬	礻
示 祭	夗
吉 祮	礻
告 祰	礻
祱
又 祲	礻 彐 冖
辰 祳	礻
戒 祴	礻
困 祵	礻
弟 祶	礻
匋 祹	礻
其 祺	礻
固 祻	礻
果 祼	礻
卒 祽	礻
夌 祾	礻
录 禄	礻
示 禁	林
周 禂	礻
直 禃	礻
卑 禆	礻
者 禇	礻
酋 禉	礻
契 禊	礻
垔 禋	礻
兹 禌	礻
呙 祸	礻
贞 祯	礻
畐 福	礻
爰 禐	礻
禺 禑	礻
彖 禒	礻
是 禔	礻
韦 祎	礻
某 禖	礻
思 禗	礻
帝 禘	礻
羔 禚	礻
眞 禛	礻
畟 禝	礻
高 禞	礻
唐 禟	礻
虒 禠	礻
马 祃	礻
羽 禢	礻 日
羽 禤	礻 罒
基 禥	礻
卸 御	彳
喜 禧	礻
異 禩	礻
单 禅	礻
覃 禫	礻
遂 禭	礻
乚 礼	礻
尔 祢	礻
寿 祷	礻
襄 禳	礻
龠 禴	礻
厶 禸	冂
厶 禹	丿 口 冂
禸 禺	日
厶 禼	卜 口 乂 冂
离 禽	人
木 禾	丿
几 秃	禾
乃 秀	禾
厶 私	禾
人 秂	禾
子 秄	禾
乇 秅	禾
干 秆	禾
丸 秇	禾
山 秈	禾
肀 秉	禾
千 秊	禾
火 秋	禾
禾 秌	火
分 秎	禾
毛 秏	禾
云 秐	禾
斗 科	禾
少 秒	禾
支 秓	禾
亢 秔	禾
比 秕	禾
氏 秖	禾
夭 秗	禾
必 秘	禾
古 秙	禾
半 秚	禾
皮 秛	禾
尼 秜	禾
禾 秝	禾
由 秞	禾
且 租	禾
丕 秠	禾
犮 秡	禾
令 秢	禾
末 秣	禾
平 秤	禾
占 秥	禾
禾 秦	龹
央 秧	禾
乍 秨	禾
失 秩	禾
氐 秪	禾
朮 秫	禾
巨 秬	禾
丿 秭	禾 丿 ㇉ 丨
台 秮	禾
同 秱	禾
寺 秲	禾
舌 秳	禾
合 秴	禾
因 秵	禾
禾 秶	次
至 秷	禾
吉 秸	禾
任 秹	禾
宅 秺	禾
多 移	禾
朱 秼	禾
甫 秿	禾
希 稀	禾
禾 稁	亠 口 冂
良 稂	禾
孚 稃	禾
夋 稄	禾
兑 税	禾
吕 稆	禾
困 稇	禾
旱 稈	禾
更 稉	禾
弟 稊	禾
呈 程	禾
余 稌	禾
肖 稍	禾
坴 稑	禾
固 稒	禾
昔 稓	禾
念 稔	禾
享 稕	禾
咅 稖	禾
卑 稗	禾
其 稘	禾
直 稙	禾
隹 稚	禾
困 稛	禾
夌 棱	木
朋 稝	禾
果 稞	禾
示 禀	亠 回
周 稠	禾
卒 稡	禾
或 稢	禾
京 稤	禾
契 稧	禾
扁 稨	禾
胃 稩	禾
复 稪	禾
畐 稫	禾
耎 稬	禾
皆 稭	禾
中 种	禾
夂 稯	禾 凶 八
胥 稰	禾
尔 称	禾
舀 稻	禾
兼 稴	禾
兹 稵	禾
彧 稶	禾
夂 稷	禾 田 儿
畜 稸	禾
真 稹	禾
屖 稺	禾
舀 稻	禾
家 稼	禾
旨 稽	禾 尤
禾 稾	高
高 稿	禾
口 谷	八 人
茸 穁	禾
惠 穗	禾
祭 穄	禾
康 穅	禾
彡 穆	禾 白 小
参 䅟	禾
禾 穈	麻
犀 穉	禾
既 穊	禾
翏 穋	禾
禾 稣	鱼
只 积	禾
页 颖	匕 禾
急 稳	禾
亀 穐	禾
異 穓	禾
黄 穔	禾
集 穕	禾
惠 穗	禾
菐 穙	禾
焦 穛	禾
童 穜	禾
遂 穟	禾
农 秾	禾
啬 穑	禾
岁 秽	禾
一 穣	禾 衣 八 井
需 穤	禾
急 稳	禾
犬 获	艸 犭
鲁 穞	禾
麃 穮	禾
襄 穰	禾
爵 穱	禾
八 穴	宀
乙 穵	穴
九 究	穴
夕 穸	穴
弓 穹	穴
工 空	穴
于 穻	穴
木 穼	穴
井 穽	穴
夭 穾	穴
牙 穿	穴
屯 窀	穴
犬 突	穴
牛 窂	穴
乍 窄	穴
目 窅	穴
乏 窆	穴
包 窇	穴
幼 窈	穴
丙 窉	穴
瓜 窊	穴
出 窋	穴
卯 窌	穴
汙 窏	穴
圭 窐	穴
至 窒	穴
心 窓	穴 厶
交 窔	穴
兆 窕	穴
告 窖	穴
囱 窗	穴
君 窘	穴
孝 窙	穴
成 窚	穴
女 窛	穴 元
臽 窞	穴
屈 窟	穴
果 窠	穴
叕 窡	穴
或 窢	穴
卒 窣	穴
音 窨	穴
呙 窝	穴
圭 洼	氵
契 窫	穴
俞 窬	穴
力 穷	穴
缶 窑	穴
缶 窑	穴
條 窱	穴
料 窲	穴
瓜 窳	穴 瓜
真 窴	穴
鸟 窎	穴
娄 窭	穴
聊 窷	穴
悉 窸	穴
吾 窹	穴 爿
规 窥	穴
心 窻	窗
巢 窼	穴
款 窾	穴
隆 窿	穴
毳 竁	穴
尞 竂	穴
串 窜	穴
巧 窍	穴
躳 竆	穴
卖 窦	穴
土 灶	火
切 窃	穴
一 立	亠 丷
几 竌	立
廾 竎	立
殳 竐	立
厷 竑	立
可 竒	亠 丷
少 竗	立
句 竘	立
占 站	立
宁 竚	立
令 竛	立
丿 龙	尤
立 竝	立
儿 竟	立 日
早 章	立
矣 竢	立
夋 竣	立
宏 竤	立
里 童	立
束 竦	立
身 竧	立
卓 竨	立
宜 竩	立
立 竖	丨 丨 又
禹 竬	立
曷 竭	立
屏 竮	立
而 端	立 山
厘 竰	立
曾 竲	立
登 竳	立
尊 竴	立
丅 竵	立 一 口 匸 丨 冂 丷
兄 竞	立
覞 竸	竝
亅 竹	丿 一 丨 丿 一
二 竺	竹
力 竻	竹
凡 竼	竹
于 竽	竹
也 竾	竹
干 竿	竹
亡 笀	竹
工 笁	竹
开 笄	竹
爻 笅	竹
巴 笆	竹
卞 笇	竹
及 笈	竹
畇 笉	竹
爪 笊	竹
牙 笌	竹
内 笍	竹
元 笎	竹
勿 笏	竹
亢 笐	竹
夭 笑	竹
今 笒	竹
比 笓	竹
以 笖	竹
冬 笗	竹
占 笘	竹
生 笙	竹
甲 笚	竹
由 笛	竹
出 笜	竹
又 笝	竹 囗
台 笞	竹
瓜 笟	竹
立 笠	竹
且 笡	竹
民 笢	竹
包 笣	竹
召 笤	竹
司 笥	竹
付 符	竹
册 笧	竹
本 笨	竹
代 笩	竹
旦 笪	竹
丿 笫	竹 丿 ㇉ 丨
丿 第	竹 弓 丨
令 笭	竹
乍 笮	竹
奴 笯	竹
弗 笰	竹
句 笱	竹
弁 笲	竹
加 笳	竹
可 笴	竹
氾 笵	竹
矢 笶	竹
卯 笷	竹
叵 笸	竹
卭 笻	竹
各 笿	竹
圭 筀	竹
曲 筁	竹
池 筂	竹
因 筃	竹
兆 筄	竹
先 筅	竹
毛 笔	竹
邛 筇	竹
舌 筈	竹
寺 等	竹
交 筊	竹
力 筋	竹 月
全 筌	竹
尹 笋	竹
如 筎	竹
伐 筏	竹
匡 筐	竹
同 筒	竹
幵 筓	竹
合 答	竹
行 筕	竹
朿 策	竹
仲 筗	竹
扣 筘	竹
耒 筙	竹
宋 筞	竹
孚 筟	竹
均 筠	竹
余 筡	竹
把 筢	竹
利 筣	竹
良 筤	竹
呂 筥	竹
完 筦	竹
见 笕	竹
含 筨	竹
甬 筩	竹
匣 筪	竹
成 筬	竹
弄 筭	竹
巫 筮	竹
助 筯	竹
作 筰	竹
攸 筱	竹
肖 筲	竹
廷 筳	竹
延 筵	竹
告 筶	竹
快 筷	竹
旱 筸	竹
更 筻	竹
咅 箁	竹
取 箃	竹
卑 箄	竹
畀 箅	竹
比 箆	内
固 箇	竹
治 箈	竹
拐 箉	竹
於 箊	竹
戋 笺	竹
到 箌	竹
匝 箍	竹 扌
虎 箎	竹
争 筝	竹
青 箐	竹
疌 箑	竹
帚 箒	竹
泊 箔	竹
其 箕	竹
林 箖	竹
廾 算	竹 目
囷 箘	竹
服 箙	竹
刂 箚	竹 合
孤 箛	竹
空 箜	竹
拑 箝	竹
卷 箞	竹
昆 箟	竹
垂 箠	竹
官 管	竹
宛 箢	竹
刺 箣	竹
卒 箤	竹
波 箥	竹
若 箬	竹
前 箭	竹
便 箯	竹
子 箰	筍
相 箱	竹
洗 箲	竹
屏 箳	竹
咸 箴	竹
省 箵	竹
胡 箶	竹
施 箷	竹
者 箸	竹
春 箺	竹
律 箻	竹
屋 箼	竹
重 箽	竹
削 箾	竹
咠 箿	竹
卩 节	竹
皇 篁	竹
星 篂	竹
眉 篃	竹
氾 范	艸
耑 篅	竹
彖 篆	竹
扁 篇	竹
封 篈	竹
巩 筑	竹
洪 篊	竹
夹 箧	竹 匚
侯 篌	竹
秋 篍	竹
眇 篎	竹
欠 篏	竹 甘
员 筼	竹
盍 篕	竹
唐 篖	竹
隻 篗	竹
芻 篘	竹
高 篙	竹
匪 篚	竹
弱 篛	竹
烝 篜	竹
冓 篝	竹
工 篞	竹 水 日
倩 篟	竹
条 筿	竹
厶 篡	竹 目 大
旁 篣	竹
马 笃	竹
栗 篥	竹
比 篦	竹 囟
隺 篧	竹
除 篨	竹
师 筛	竹
虒 篪	竹
手 篫	竹 巩
龙 笼	竹
部 篰	竹
彗 篲	竹
毕 筚	竹
逐 篴	竹
焉 篶	竹
逢 篷	竹
㔾 篹	竹 目 大
捭 篺	竹
票 篻	竹
兜 篼	竹
御 篽	竹
戍 篾	竹 罒
责 箦	竹
徙 簁	竹
移 簃	竹
扈 簄	竹
產 簅	竹
寇 簆	竹
族 簇	竹
幷 簈	竹
造 簉	竹
基 簊	竹
皿 簋	竹 艮
欶 簌	竹
娄 篓	竹
措 簎	竹
鹿 簏	竹
衰 簑	竹
么 簒	竹 目 大
衰 簔	竹
勒 簕	竹
肃 箫	竹
博 簙	竹
巾 簚	竹 罒 戈
斯 簛	竹
尞 簝	竹
単 箪	竹
覃 簟	竹
盙 簠	竹
间 简	竹
贵 篑	竹
登 簦	竹
黄 簧	竹
巽 簨	竹
日 簮	竹 夫 夫
肃 箫	竹
路 簬	竹
口 簭	竹 筮 人
日 簮	竹 夫 夫
牌 簰	竹
脾 簲	竹
幹 簳	竹
虡 簴	竹
祿 簶	竹
詹 檐	木
皮 簸	竹 其
当 筜	竹
塞 簺	竹
搆 簼	竹
佥 签	竹
巾 帘	穴
薄 簿	竹
留 籀	竹 扌
监 篮	竹
與 籅	竹
蒦 籆	竹
豪 籇	竹
甄 籈	竹
翟 籊	竹
寿 筹	竹
耤 籍	竹
滕 籐	竹
良 籑	竹 目 大
畱 籒	竹 扌
潘 籓	竹
数 䉤	竹
榴 籕	竹
霍 籗	竹
縢 籘	竹
录 箓	竹
戋 篯	竹
择 箨	竹
嬴 籝	竹
禦 籞	竹
赖 籁	竹
龙 笼	竹
佥 签	竹
龠 籥	竹
鍾 籦	竹
豦 籧	竹
边 笾	竹
断 簖	竹
离 篱	竹
罗 箩	竹
贏 籯	竹
矍 籰	竹
隹 籱	竹 雨 隹
于 吁	口
木 米	丷
十 籵	米
几 籶	米
乇 籷	米
卂 籸	米
女 籹	米
乞 籺	米
山 籼	米
子 籽	米
刃 籾	米
寸 籿	米
千 粁	米
比 粃	米
反 粄	米
勿 粅	米
少 粆	米
亢 粇	米
丑 粈	米
分 粉	米
米 粊	比
卆 粋	米
毛 粍	米
尺 粎	米
巴 粑	米
立 粒	米
甘 粓	米
巨 粔	米
白 粕	米
末 粖	米
且 粗	米
占 粘	米
由 粙	米
也 粚	米 丿 一
丨 肃	肀 八 丿
米 粜	出
西 粞	米
米 粟	襾
共 粠	米
同 粡	米
米 粢	次
弓 粥	弓 米
舛 粦	米
百 粨	米
孚 粰	米
米 粱	氵 刀 八
米 粲	歺 又
更 粳	米
里 粴	米
亏 粤	丶 冂 米
录 粶	米
匊 粷	米
其 粸	米
卒 粹	米
卑 粺	米
巜 粼	粦
宗 粽	米
青 精	米
果 粿	米
甚 糂	米
扁 糄	米
柔 糅	米
面 糆	米
侯 糇	米
胥 糈	米
宗 粽	米
胡 糊	米
前 糋	米
日 糌	米 夂 人
兹 糍	米
厘 糎	米
屑 糏	米
尃 糐	米
弱 糑	米
用 糒	米 艹 厂
殳 糓	士 冖 一 米
蚤 糔	米
羔 糕	米
唐 糖	米
臭 糗	米
造 糙	米
庄 粧	米
堂 糛	米
米 糜	麻
参 糁	米
共 粪	米
曹 糟	米
康 糠	米
竟 糡	米
莫 糢	米
朁 糣	米
散 糤	米
需 糥	米
喜 糦	米
良 粮	米
強 糨	米
米 糪	辟
睘 糫	米
需 糯	米
才 团	囗
米 糱	辥
厉 粝	米
米 糳	丵 臼 殳
米 籴	入
米 糵	薛
翟 糶	粜
小 糸	幺
小 系	丿 幺
丩 纠	纟
己 纪	纟
寸 纣	纟
勺 约	纟
工 红	纟
于 纡	纟
乞 纥	纟
丸 纨	纟
刃 纫	纟
糸 紊	文
文 纹	纟
内 纳	纟
丑 纽	纟
予 纾	纟
屯 纯	纟
比 纰	纟
引 纼	纟
少 纱	纟
厷 纮	纟
氏 纸	纟
及 级	纟
分 纷	纟
云 纭	纟
壬 纴	纟
糸 素	丰
方 纺	纟
糸 索	十 冖
糸 紥	扎
糸 紫	此
乚 扎	扌
丝 累	田
田 细	纟
犮 绂	纟
世 绁	纟
申 绅	纟
一 纻	纟 宀
召 绍	纟
甘 绀	纟
弗 绋	纟
台 绐	纟
出 绌	纟
冬 终	纟
且 组	纟
半 绊	纟
圣 经	纟
行 绗	纟
吉 结	纟
色 绝	纟
糸 絛	攸
糸 絜	丰 刀
夸 绔	纟
交 绞	纟
各 络	纟
旬 绚	纟
合 给	纟
戎 绒	纟
糸 絫	厽
糸 絭	𠔉
糸 絮	如
至 绖	纟
充 统	纟
纟 丝	纟
夅 绛	纟
会 绘	纟
色 绝	纟
肙 绢	纟
邦 绑	纟
肖 绡	纟
更 绠	纟
弟 绨	纟
谷 绤	纟
妥 绥	纟
圣 经	纟
系 綔	夸
宗 综	纟
垂 缍	纟
录 绿	纟
周 绸	纟
卷 绻	纟
糸 綤	邵
糸 綦	其
戋 线	纟
受 绶	纟
隹 维	纟
糸 綮	户 攵
匋 绹	纟
官 绾	纟
冈 纲	纟
乂 网	冂 乂
朋 绷	纟
叕 缀	纟
木 采	爫
仑 纶	纟
咎 绺	纟
奇 绮	纟
定 绽	纟
卓 绰	纟
夌 绫	纟
帛 绵	纟
昆 绲	纟
甾 缁	纟
丝 紧	丨 丨 又
非 绯	纟
心 总	丷 口
系 緐	每
录 绿	纟
者 绪	纟
英 绬	纟
尚 绱	纟
者 绪	纟
相 缃	纟
咸 缄	纟
革 缂	纟
戋 线	纟
泉 缐	纟
系 緜	帛
咠 缉	纟
段 缎	纟
帝 缔	纟
昬 缗	纟
彖 缘	纟
思 缌	纟
扁 编	纟
爰 缓	纟
面 缅	纟
韦 纬	纟
侯 缑	纟
少 缈	纟 目
絜 緳	广
一 练	纟 东
便 缏	纟
是 缇	纟
攴 致	至
昷 缊	纟
厘 缠	纟
心 总	丷 口
丝 萦	艹 冖
晋 缙	纟
益 缢	纟
追 缒	纟
糸 縏	般
刍 绉	纟
兼 缣	纟
昷 缊	纟
衰 缞	纟
尃 缚	纟
真 缜	纟
高 缟	纟
辱 缛	纟
殳 縠	士 冖 系
絭 縢	月
厶 县	且
从 纵	纟
条 绦	纟
逢 缝	纟
离 缡	纟
宿 缩	纟
从 纵	纟
累 缧	纟
曼 缦	纟
糸 絷	执
娄 缕	纟
票 缥	纟
糸 縻	麻
心 总	丷 口
责 绩	纟
糸 繁	每 攵
朋 绷	纟
糸 繄	殹
巢 缫	纟
翏 缪	纟
系 繇	月 缶
糸 繋	軗
秀 绣	纟
曾 缯	纟
只 织	纟
善 缮	纟
尞 缭	纟
卓 繛	素
尧 绕	纟
糸 繠	惢
秀 绣	纟
贵 缋	纟
糸 繤	苜 大
黾 绳	纟
会 绘	纟
小 系	丿 幺
虫 茧	草
畺 缰	纟
睘 缳	纟
喿 缲	纟
敫 缴	纟
糸 繴	辟
丨 绎	纟 又 二
米 继	纟 丨 一
宾 缤	纟
遣 缱	纟
糸 纂	竹 目 大
页 颣	米 糸
颉 缬	纟
广 纩	纟
卖 续	纟
糸 纍	畾
里 缠	纟 广
里 缠	纟 广
婴 缨	纟
丿 才	一 亅
千 纤	纟
赞 缵	纟
縣 纛	毒
览 缆	纟
山 缶	丿 二
卩 缷	缶
工 缸	缶
灬 缹	缶
夬 缺	缶
瓦 缻	缶
本 钵	钅
并 缾	缶
后 缿	缶
缶 罄	殸
虖 罅	缶
尊 罇	缶
云 坛	土
掌 罉	缶
缶 罋	雍
缶 罂	贝 贝
缶 罍	畾
云 坛	土
雚 罐	缶
一 罒	冖 丨 丨
乂 罓	冖
亡 罔	冂 丷 一
干 罕	罓
不 罘	罒
木 罙	罒
瓜 罛	罒
主 罜	罒
且 罝	罒
矛 罞	罒
古 罟	罒
民 罠	罒
正 罡	罒
圭 罣	罒
弟 罤	罒
肙 罥	罒
孚 罦	罒
林 罧	罒
奄 罨	罒
卓 罩	罒
非 罪	罒
卦 罫	罒
叕 罬	罒
或 罭	罒
直 置	罒
音 罯	罒
刂 罚	罒 讠
南 罱	罒
者 署	罒
思 罳	罒
马 骂	口 口
留 罶	罒
去 罢	罒
刂 罚	罒 讠
隹 罹	罒 忄
巢 罺	罒
尉 罻	罒
剡 罽	罒 厂
曾 罾	罒
童 罿	罒
畱 羀	罒
幕 羃	罒
夕 罗	罒
灬 罴	罢
奇 羇	罒 革
马 羁	罒 革
丨 羊	丷 三
干 羋	卝 丨
儿 羌	羊
羊 羍	大
大 美	羊
彡 羏	羊
久 羐	艹 土
久 羑	羊
分 羒	羊
巴 羓	羊
灬 羔	羊
永 羕	羊
殳 羖	羊
厶 羗	羌
羊 羘	月
火 羙	羊
令 羚	羊
弗 羛	羊
宁 羜	羊
氐 羝	羊
丑 羞	羊 丿
夷 羠	羊
戎 羢	羊
羊 羣	君
羊 群	君
圣 羟	羊
完 羦	羊
夋 羧	羊
次 羡	羊
乂 义	丶
空 羫	羊
咸 羬	羊
俞 羭	羊
夫 羮	羔 一
曷 羯	羊
炭 羰	羊
原 羱	羊
戈 羲	羊 禾 丂
番 羳	羊
亶 羶	羊
亶 羶	羊
凡 羸	亡 口 月 羊
美 羹	羔
需 羺	羊
羴 羼	尸
习 羽	习
工 羾	羽
廾 羿	羽
中 翀	羽
羽 翁	公
分 翂	羽
羽 翃	厷
支 翄	羽
羽 翅	支
卆 翆	羽
犮 翇	羽
羽 翈	甲
羽 翉	本
羽 翊	立
立 翋	羽
立 翌	羽
皮 翍	羽
羽 翎	令
彡 翏	羽 人
失 翐	羽
句 翑	羽
丶 习	刁
羽 翓	吉
羽 翔	羊
羽 翕	合
羽 翖	合
羽 翗	多
羽 翛	攸
羽 翝	宏
京 翞	羽
隹 翟	羽
卒 翠	羽
羽 翡	非
羽 翢	周
妾 翣	羽
冊 翤	口
羽 翥	者
羽 翦	前
羽 翧	宣
是 翨	羽
羽 翩	扁
夂 翪	羽 凶 八
元 翫	習
军 翚	羽
侯 翭	羽
羽 翮	鬲
高 翯	羽
羽 翰	十 日 十 人
羽 翲	票
羽 翳	殹
羽 翷	粦
羽 翘	尧
羽 翱	皋
羽 翻	番
異 翼	羽
羽 翙	岁
羽 翾	睘
翟 耀	光
匕 老	耂
丿 耂	土
丂 考	耂
毛 耄	老
日 者	耂
日 耆	老
句 耇	耂
句 耈	老
口 耉	考
至 耊	耂
至 耋	老
丨 而	一 丶 冂 丨
女 耍	而
大 耎	而
彡 耏	而
寸 耐	而
而 耑	山
未 耒	一
丁 耓	耒
子 耔	耒
井 耕	耒
少 耖	耒
毛 耗	耒
云 耘	耒
巴 耙	耒
皮 耚	耒
台 耛	耒
一 耜	耒 尸 乛
且 耝	耒
加 耞	耒
巨 耟	耒
合 耠	耒
助 耡	耒
昔 耤	耒
尚 耥	耒
禺 耦	耒
辱 耨	耒
冓 耩	耒
旁 耪	耒
責 耫	耒
娄 耧	耒
劳 耢	耒
蒦 耯	耒
憂 耰	耒
磨 耱	耒
褱 耲	耒
乚 耴	耳
丁 耵	耳
阝 耶	耳
耳 耷	大
今 耹	耳
云 耺	耳
冄 耼	耳
冘 耽	耳
厷 耾	耳
火 耿	耳
戈 聀	耳
冉 聃	耳
彡 聄	耳 人
矢 聅	耳
令 聆	耳
正 聇	耳
幼 聈	耳
出 聉	耳
卯 聊	耳
兆 聎	耳
而 聏	耳
吉 聐	耳
耳 聑	耳
舌 聒	耳
告 聕	耳
土 圣	又
丂 聘	耳 由
青 聙	耳
乑 聚	耳 又
卑 聛	耳
空 聜	耳
或 聝	耳
耳 闻	门
耳 聟	知
并 聠	耳
忩 聡	耳
亭 聤	耳
禹 聥	耳
葱 聦	耳
癸 聧	耳
大 聫	耳 幺 幺
翁 聬	耳
鬼 聭	耳
关 联	耳
总 聪	耳
耳 聱	敖
丨 声	士 尸
耳 耸	从
斤 听	口
贵 聩	耳
又 聂	耳 又
只 职	耳
詹 聸	耳
宁 聍	耳
斤 听	口
斤 听	口
耳 聋	龙
丨 聿	彐 二
丨 肀	彐
聿 肁	户
聿 肂	歹
聿 肄	匕 矢
丨 肃	肀 八 丿
聿 肆	镸
聿 肇	户 攴
聿 肈	户 戈
入 肉	冂 入
乙 肊	月
力 肋	月
几 肌	月
九 肍	月
月 肎	冖
肉 肏	入
乞 肐	月
勺 肑	月
丸 肒	月
月 肓	亡
也 肔	月
刃 肕	月
月 肖	小
女 肗	月
寸 肘	月
月 肙	口
土 肚	月
工 肛	月
彡 肜	月
干 肝	月
义 肞	月
亏 肟	月
殳 股	月
支 肢	月
今 肣	月
巴 肥	月
分 肦	月
不 肧	月
丰 肨	月
月 肩	戶
方 肪	月
屯 肫	月
尤 肬	月
內 肭	月
亢 肮	月
月 肯	止
犬 肰	月
厷 肱	月
月 育	亠 厶
勿 肳	月
斤 肵	月
比 肶	月
欠 肷	月
十 肸	月 八
兮 肹	月
巿 肺	月
肉 肻	卜 冖
井 肼	月
太 肽	月
申 胂	月
月 胃	田
月 胄	由
失 胅	月
弗 胇	月
犮 胈	月
白 胉	月
句 胊	月
占 胋	月
月 背	北
瓜 胍	月
台 胎	月
丿 胏	月 丿 ㇉ 丨
出 胐	月
只 胑	月
尼 胒	月
平 胓	月
月 胔	此
付 胕	月
半 胖	月
彡 胗	月 人
玄 胘	月
乍 胙	月
丕 胚	月
甲 胛	月
氐 胝	月
包 胞	月
母 胟	月
去 胠	月
月 胡	古
可 胢	月
也 胣	月 丿 一
乚 胤	丿 幺 月
月 胥	疋
央 胦	月
卡 胩	月
月 胬	奴
因 胭	月
夅 胮	月
夸 胯	月
夷 胰	月
光 胱	月
亥 胲	月
各 胳	月
同 胴	月
至 胵	月
月 胷	匈
匈 胸	月
而 胹	月
安 胺	月
行 胻	月
匕 能	厶 月 匕
肉 胾	土 戈
月 脀	丞
兆 脁	月
旨 脂	月
色 脃	月
灰 脄	月
办 胁	月
危 脆	月
劦 脇	月
永 脉	月
二 脊	月 人 二
杀 脎	月
米 脒	月
免 脕	月
孛 脖	月
口 脗	月 勿
完 脘	月
求 脙	月
圣 胫	月
自 脜	月 一
亨 脝	月
坐 脞	月
寽 脟	月
延 脠	月
廷 脡	月
每 脢	月
月 脣	辰
辰 脤	月
忒 脦	月
夋 脧	月
束 脨	月
月 脩	攸
希 脪	月
兑 脱	月
孚 脬	月
呈 脭	月
妥 脮	月
甫 脯	月
豆 脰	月
尿 脲	月
否 脴	月
吴 脵	月
利 脷	月
长 胀	月
卒 脺	月
隹 脽	月
卑 脾	月
表 脿	月
并 胼	月
果 腂	月
卷 腃	月
垂 腄	月
炎 腅	月
典 腆	月
委 腇	月
青 腈	月
兒 腉	月
夜 腋	月
念 腍	月
月 肾	丨 丨 又
叕 腏	月
肉 腐	广 付
府 腑	月
居 腒	月
非 腓	月
空 腔	月
宛 腕	月
东 胨	月
畁 腗	月
宗 腙	月
定 腚	月
屋 腛	月
某 腜	月
耎 腝	月
彖 腞	月
室 腟	月
奏 腠	月
呙 脶	月
禺 腢	月
帝 腣	月
音 腤	月
星 腥	月
凵 脑	月 亠 乂
俞 腧	月
耑 腨	月
南 腩	月
中 肿	月
柔 腬	月
咢 腭	月
思 腮	月
盾 腯	月
要 腰	月
建 腱	月
畏 腲	月
却 脚	月
臾 腴	月
叚 腵	月
段 腶	月
畐 腷	月
丿 肠	月 弓 丿
复 腹	月
泉 腺	月
退 腿	月
旁 膀	月
兼 膁	月
月 膂	旅
昷 腽	月
叟 膄	月
唐 膅	月
素 膆	月
追 膇	月
鬲 膈	月
益 膉	月
尃 膊	月
脊 膌	月
比 膍	月 囟
奚 膎	月
月 膏	高
月 膐	旅
丿 肠	月 弓 丿
鹿 膔	月
国 腘	月
逢 膖	月
崔 膗	月
票 膘	月
強 膙	月
夫 肤	月
堂 膛	月
莫 膜	月
桼 膝	月
率 膟	月
交 胶	月
眷 膡	月
窒 膣	月
成 膥	末
粦 膦	月
童 膧	月
彭 膨	月
贰 腻	月
啻 膪	月
尞 膫	月
毳 膬	月
登 膯	月
番 膰	月
焦 膲	月
善 膳	月
萃 膵	月
月 膺	广 人 隹
亶 膻	月
旦 胆	月
会 脍	月
农 脓	月
殿 臀	月
廉 臁	月
辟 臂	月
雍 臃	月
豦 臄	月
蜀 臅	月
意 臆	月
雋 臇	月
葛 臈	月
佥 脸	月
喿 臊	月
月 臋	殿
鼓 臌	月
齐 脐	月
翠 臎	月
宾 膑	月
熏 臐	月
需 臑	月
蒦 臒	月
庄 脏	月
麃 臕	月
月 臖	興
昔 腊	月
燕 臙	月
卢 胪	月
霍 臛	月
凡 臝	亡 口 月 果
瞿 臞	月
庄 脏	月
肉 脔	亦
赞 臜	月
丶 臣	巨 丶
又 臤	臣
卜 卧	臣
臣 臧	爿 戊
丨 临	丨 丨 丿 一 丶 口
夰 臩	臦
目 自	丶
乚 臫	自
木 臬	自
犬 臭	自
人 臮	自 丅 人
二 臯	自 二 十
死 臰	自
方 臱	自 穴
危 臲	臬
土 至	一 厶
攵 致	至
各 臵	至
存 臶	至
至 臷	土 戈
至 臸	至
成 臹	至
口 台	厶
秦 臻	至
彐 臼	丿 丨 一
臼 臽	刀
人 臾	臼
臼 臿	干
臼 舀	爫
廾 舁	臼
臼 舂	夫 一
舄 舃	臼 一 勹 灬
灬 舄	臼 勹
男 舅	臼
一 与	一 ㇉
六 兴	丷
丨 举	兴 二
日 旧	丨
且 舋	臼 同 冖
口 舌	千
舌 舍	人
丩 舏	舌
氏 舐	舌
冉 舑	舌
予 舒	舍
易 舓	舌
忝 舔	舌
炎 舕	舌
甫 铺	钅
甫 铺	钅 钅
官 舘	人 舌
舌 舙	舌 舌
詹 舚	舌
丨 舛	夕 匸
舛 舜	爫 冖
牟 舝	土 巛 冖
舛 舞	丿 一 一 丨 丨 丨 丨 一
丨 舟	丶 冂 一 丶
刀 舠	舟
工 舡	舟
山 舢	舟
巴 舥	舟
太 舦	舟
凡 舧	舟
反 舨	舟
公 舩	舟
亢 航	舟
方 舫	舟
殳 般	舟
比 舭	舟
中 舯	舟
令 舲	舟
由 舳	舟
乍 舴	舟
它 舵	舟
白 舶	舟
玄 舷	舟
可 舸	舟
口 船	舟 八
甲 舺	舟
共 舼	舟
夅 舽	舟
西 舾	舟
孚 艀	舟
告 艁	舟
夆 艂	舟
里 艃	舟
肖 艄	舟
余 艅	舟
良 艆	舟
廷 艇	舟
尾 艉	舟
帛 艊	舟
孟 艋	舟
念 艌	舟
居 艍	舟
皇 艎	舟
首 艏	舟
夂 艐	舟 凶 八
扁 艑	舟
冒 艒	舟
枼 艓	舟
旁 艕	舟
差 艖	舟
益 艗	舟
叟 艘	舟
仓 舱	舟
曹 艚	舟
筄 艞	舟
童 艟	舟
义 舣	舟
戈 艥	舟 咠
见 舰	舟
蒦 艧	舟
蒙 艨	舟
卢 舻	舟
毚 艬	舟
艮 良	丶
艮 艰	又
巴 色	刀
色 艴	弗
色 艵	并
色 艳	丰
色 艳	丰
山 艸	山
丨 艹	一 丨
力 艻	艸
丁 艼	艸
九 艽	艸
乂 艾	艸
乃 艿	艸
刀 芀	艸
几 芁	艸
凡 芃	艸
丸 芄	艸
弋 芅	艸
叉 芆	艸
巾 芇	艸
丨 芈	艸 卝 二
干 芉	艸
千 芊	艸
于 芋	艸
亏 芌	艸
勺 芍	艸
弓 芎	艸
土 芏	艸
下 芐	艸
己 芑	艸
亡 芒	艸
子 芓	艸
艸 芔	屮
夕 芕	艸
大 芖	艸
比 芘	艸
夫 芙	艸
屯 芚	艸
尹 芛	艸
之 芝	艸
气 芞	艸
殳 芟	艸
文 芠	艸
欠 芡	艸
仁 芢	艸
不 芣	艸
孔 芤	艸
介 芥	艸
予 芧	艸
及 芨	艸
今 芩	艸
氏 芪	艸
元 芫	艸
分 芬	艸
巴 芭	艸
內 芮	艸
心 芯	艸
支 芰	艸
化 花	艸
七 芲	艸 人
方 芳	艸
勿 芴	艸
夬 芵	艸
勾 芶	艸
止 芷	艸
云 芸	艸
斤 芹	艸
夭 芺	艸
彐 刍	刀
毛 芼	艸
牙 芽	艸
巿 芾	艸
仍 芿	艸
亢 苀	艸
火 苂	艸
友 苃	艸
卞 苄	艸
刈 苅	艸
匹 苉	艸
厄 苊	艸
弔 苐	艸
夗 苑	艸
冉 苒	艸
令 苓	艸
台 苔	艸
召 苕	艸
由 苖	艸
田 苗	艸
冋 苘	艸
立 苙	艸
用 苚	艸
可 苛	艸
目 苜	艸
北 苝	艸
包 苞	艸
句 苟	艸
民 苠	艸
以 苡	艸
一 苢	艸 尸 乛
巨 苣	艸
丕 苤	艸
右 若	艸
古 苦	艸
一 苎	艸 宀
尼 苨	艸
白 苩	艸
丙 苪	艸
占 苫	艸
囚 苬	艸
幼 苭	艸
仙 苮	艸
本 苯	艸
弘 苰	艸
央 英	艸
乍 苲	艸
冬 苳	艸
且 苴	艸
失 苵	艸
尒 苶	艸
甘 苷	艸
乎 苸	艸
母 苺	艸
付 苻	艸
生 苼	艸
瓜 苽	艸
必 苾	艸
未 苿	艸
弗 茀	艸
出 茁	艸
戊 茂	艸
氾 范	艸
加 茄	艸
矛 茅	艸
卯 茆	艸
犮 茇	艸
此 茈	艸
末 茉	艸
丘 茊	艸
氐 茋	艸
仕 茌	艸
句 茍	艸
穴 茓	艸
各 茖	艸
名 茗	艸
刕 茘	艸
戎 茙	艸
印 茚	艸
艮 茛	艸
西 茜	艸
臣 茝	艸
臣 茞	艸
聿 茟	艸
休 茠	艸
字 茡	艸
列 茢	艸
多 茤	艸
圭 茥	艸
朿 茦	艸
次 茨	艸
后 茩	艸
光 茪	艸
亡 茫	艸 氵
在 茬	艸
交 茭	艸
尗 茮	艸
伏 茯	艸
乂 茰	艸 由
朱 茱	艸
幺 兹	丷 一 幺
江 茳	艸
回 茴	艸
因 茵	艸
小 茶	艸 人 一
伐 茷	艸
耳 茸	艸
如 茹	艸
充 茺	艸
艸 茻	艸
同 茼	艸
仲 茽	艸
巩 茿	艸
旬 荀	艸
亘 荁	艸
夸 荂	艸
全 荃	艸
亥 荄	艸
合 荅	艸
行 荇	艸
舛 荈	艸
早 草	艸
刂 荆	井
而 荋	艸
安 荌	艸
收 荍	艸
至 荎	艸
任 荏	艸
夷 荑	艸
巟 荒	艸
并 荓	艸
劦 荔	艸
肋 荕	艸
老 荖	艸
戍 荗	艸
土 庄	广
杜 荰	艸
尾 荱	艸
里 荲	艸
豆 荳	艸
扶 荴	艸
忍 荵	艸
吟 荶	艸
何 荷	艸
孛 荸	艸
步 荹	艸
均 荺	艸
狄 荻	艸
余 荼	艸
妥 荽	艸
夋 荾	艸
成 荿	艸
辰 莀	艸
巫 莁	艸
別 莂	艸
希 莃	艸
更 莄	艸
甫 莆	艸
助 莇	艸
沒 莈	艸
利 莉	艸
土 庄	广
作 莋	艸
莌
求 莍	艸
沙 莎	艸
抄 莏	艸
沈 莐	艸
夆 莑	艸
吕 莒	艸
每 莓	艸
囧 莔	艸
杏 莕	艸
圣 茎	艸
辛 莘	艸
君 莙	艸
延 莚	艸
廷 莛	艸
攸 莜	艸
坐 莝	艸
完 莞	艸
今 莟	艸
秀 莠	艸
足 莡	艸
夹 荚	艸
忘 莣	艸
酉 莤	艸
狃 莥	艸
肖 莦	艸
见 苋	艸
良 莨	艸
孚 莩	艸
我 莪	艸
大 莫	艸 日
免 莬	艸
即 莭	艸
男 莮	艸
沐 莯	艸
坎 莰	艸
廾 莽	艸 大
奔 莾	艸
刺 莿	艸
宛 菀	艸
青 菁	艸
的 菂	艸
洰 菃	艸
官 菅	艸
取 菆	艸
姑 菇	艸
拉 菈	艸
彔 菉	艸
匊 菊	艸
味 菋	艸
囷 菌	艸
念 菍	艸
昆 菎	艸
河 菏	艸
人 菐	业 丷 三
甾 菑	艸
杲 菒	艸
木 果	日
服 菔	艸
昌 菖	艸
抽 菗	艸
松 菘	艸
垂 菙	艸
采 菜	艸
犮 菝	艸
丿 菞	艸 禾 勹
兔 菟	艸
波 菠	艸
函 菡	艸
抱 菢	艸
卷 菤	艸
析 菥	艸
近 菦	艸
底 菧	艸
妾 菨	艸
咅 菩	艸
宕 菪	艸
三 菫	艸 丅 口
沼 菬	艸
治 菭	艸
庚 菮	艸
十 华	化
孤 菰	艸
夌 菱	艸
非 菲	艸
金 菳	艸
奄 菴	艸
罔 菵	艸
奉 菶	艸
帚 菷	艸
因 烟	火
沮 菹	艸
肩 菺	艸
林 菻	艸
炎 菼	艸
叔 菽	艸
忝 菾	艸
到 菿	艸
虎 萀	艸
其 萁	艸
和 萂	艸
卒 萃	艸
匋 萄	艸
旾 萅	艸
卑 萆	艸
长 苌	艸
肥 萉	艸
来 莱	艸
妻 萋	艸
明 萌	艸
平 萍	艸 氵
委 萎	艸
臽 萏	艸
疌 萐	艸
兖 萒	艸
宜 萓	艸
招 萔	艸
齐 荠	艸
兒 萖	艸
宗 萗	艸
奈 萘	艸
廾 萛	艸 目
帖 萜	艸
朋 萠	艸
秋 萩	艸
科 萪	艸
香 萫	艸
刀 万	一
禹 萭	艸
俞 萮	艸
柬 萰	艸
宣 萱	艸
爰 萲	艸
南 萳	艸
则 荝	艸
呙 莴	艸
春 萶	艸
削 萷	艸
臾 萸	艸
扁 萹	艸
冒 萺	艸
音 萻	艸
咢 萼	艸
洛 落	艸
盈 萾	艸
活 萿	艸
括 葀	艸
姜 葁	艸
勉 葂	艸
昨 葃	艸
胙 葄	艸
俎 葅	艸
保 葆	艸
柔 葇	艸
枲 葈	艸
十 叶	口
弇 葊	艸
朐 葋	艸
姦 葌	艸
畐 葍	艸
律 葎	艸
津 葏	艸
盆 葐	艸
封 葑	艸
红 荭	艸
洪 葓	艸
侯 葔	艸
衍 葕	艸
突 葖	艸
目 着	羊 丿
者 著	艸
一 葘	艸 甾
相 葙	艸
甚 葚	艸
曷 葛	艸
契 葜	艸
弭 葞	艸
皇 葟	艸
侵 葠	艸
匍 葡	艸
盇 葢	艸
重 董	艸
纣 荮	艸
前 葥	艸
韦 苇	艸
勃 葧	艸
畏 葨	艸
皅 葩	艸
刂 葪	艸 角
胡 葫	艸
廾 葬	艸 死
叚 葭	艸
段 葮	艸
约 药	艸
俊 葰	艸
泉 葲	艸
威 葳	艸
咸 葴	艸
癸 葵	艸
亭 葶	艸
军 荤	艸
思 葸	艸
施 葹	艸
咠 葺	艸
夂 葼	艸 凶 八
要 葽	艸
怨 葾	艸
眉 葿	艸
述 蒁	艸
帝 蒂	艸
彖 蒃	艸
冠 蒄	艸
女 蒆	艸 巩
皆 蒈	艸
派 蒎	艸
鬼 蒐	艸
殷 蒑	艸
纯 莼	艸
时 莳	艸
昷 蒀	艸
真 蒖	艸
浪 蒗	艸
挐 蒘	艸
冡 蒙	艸
鬲 蒚	艸
缺 蒛	艸
示 蒜	艸 示
原 蒝	艸
位 莅	艸
句 蒟	艸 立
息 蒠	艸
旁 蒡	艸
除 蒢	艸
徐 蒣	艸
涂 蒤	艸
留 蒥	艸
又 蒦	草 隹
占 蒧	艸 戊
倩 蒨	艸
租 蒩	艸
尃 蒪	艸
差 蒫	艸
冤 蒬	艸
芻 蒭	艸
隺 蒮	艸
刂 蒯	萠
般 蒰	艸
捕 蒱	艸
浦 蒲	艸
朔 蒴	艸
奚 蒵	艸
烝 蒸	艸
兼 蒹	艸
疾 蒺	艸
弱 蒻	艸
仓 苍	艸
恩 蒽	艸
迷 蒾	艸
高 蒿	艸
孙 荪	艸
秦 蓁	艸
冥 蓂	艸
叟 蓃	艸
畜 蓄	艸
流 蓅	艸
席 蓆	艸
骨 蓇	艸
郎 蓈	艸
容 蓉	艸
翁 蓊	艸
皿 盖	艸 羊
夎 蓌	艸
耆 蓍	艸
唐 蓎	艸
瓜 蓏	艸 瓜
辱 蓐	艸
衰 蓑	艸
倍 蓓	艸
羔 蓔	艸
桂 蓕	艸
比 蓖	艸 囟
徒 蓗	艸
修 蓚	艸
敇 蓛	艸
浸 蓡	艸
朗 蓢	艸
條 蓧	艸
月 蓨	艸 攸
通 蓪	艸
逐 蓫	艸
逢 蓬	艸
庵 蓭	艸
连 莲	艸
从 苁	艸
徙 蓰	艸
洴 蓱	艸
堇 蓳	艸
捷 蓵	艸
唯 蓶	艸
推 蓷	艸
曹 蓸	艸
御 蓹	艸
翏 蓼	艸
毕 荜	艸
宿 蓿	艸
部 蔀	艸
章 蔁	艸
累 蔂	艸
强 蔃	艸
淩 蔆	艸
既 蔇	艸
票 蔈	艸
衮 蓘	艸
焊 蔊	艸
淑 蔋	艸
欶 蔌	艸
鹿 蔍	艸
商 蔏	艸
啇 蔐	艸
戍 蔑	艸 罓
焄 蔒	艸
曼 蔓	艸
丶 卜	丨
虘 蔖	艸
庶 蔗	艸
旋 蔙	艸
尉 蔚	艸
斛 蔛	艸
敖 蔜	艸
眯 蔝	艸
娄 蒌	艸
族 蔟	艸
終 蔠	艸
祭 蔡	艸
婆 蔢	艸
将 蒋	艸
密 蔤	艸
怱 葱	艸
鸟 茑	艸
彗 蔧	艸
圈 蔨	艸
寅 蔩	艸
焉 蔫	艸
疏 蔬	艸
阴 荫	艸
扈 蔰	艸
寇 蔲	艸
清 蔳	艸
林 麻	广
臣 蔵	艸 戉
兜 蔸	艸
寇 蔻	艸
敝 蔽	艸
木 蔾	菞
棘 蕀	艸
寻 荨	艸
勝 蕂	艸
番 蕃	艸
湡 蕅	艸
贝 蒇	艸 戊
覃 蕈	艸
焦 蕉	艸
惢 蕊	艸
歮 蕋	艸
畾 蕌	艸
渝 蕍	艸
乔 荞	艸
十 蕐	艸 二 人 人 人 人
买 荬	艸
云 芸	艸
報 蕔	艸
犹 莸	艸
渠 蕖	艸
路 蕗	艸
尧 荛	艸
惠 蕙	艸
亏 蕚	艸 品
稊 蕛	艸
悲 蕜	艸
最 蕞	艸
絮 蕠	艸
贵 蒉	艸
舜 蕣	艸
生 蕤	艸 豕
雅 蕥	艸
厥 蕨	艸
汤 荡	艸
无 芜	艸
童 蕫	艸
肃 萧	艹
舄 蕮	艸
隆 蕯	艸
飧 蕵	艸
零 蕶	艸
预 蓣	艸
遐 蕸	艸
雍 蕹	艸
戢 蕺	艸
共 蕻	艸 镸
肆 蕼	艸
雷 蕾	艸
煖 蕿	艸
温 蕰	艸
敫 薂	艸
滈 薃	艸
尃 薄	艸 氵
媷 薅	艸
微 薇	艸
会 荟	艸
歲 薉	艸
刂 蓟	艸 鱼
乡 芗	艸
卝 薎	艸
意 薏	艸
稜 薐	艸
女 姜	羊
粲 薒	艸
又 薓	艸 氵 帚
啬 蔷	艸
廉 薕	艸
达 荙	艸
雉 薙	艸
辛 薛	艸 户 乛 一
辟 薜	艸
詹 薝	艸
飱 薞	艸
佥 莶	艸
鼎 薡	艸
解 薢	艸
鼓 薣	艸
韭 薤	艸 歹
蜀 薥	艸
存 荐	艸
死 薧	艸 亠 口 冂
死 薨	艸 罒 冖
产 萨	艸 阜
新 薪	艸
熏 薰	艸
约 药	艸
署 薯	艸
熏 薰	艸
远 䓕	艸
貍 薶	艸
需 薷	艸
漂 薸	艸
臺 薹	艸
齐 荠	艸
漅 薻	艸
塵 薼	艸
甄 薽	艸
爾 薾	艸
疑 薿	艸
槀 藁	艸
聚 藂	艸
歊 藃	艸
綦 藄	艸
搴 藆	艸
睽 藈	艸
昔 借	亻
稨 藊	艸
翟 藋	艸
蜜 藌	艸
监 蓝	艸
尽 荩	艸
臧 藏	艸
貌 藐	艸
夐 藑	艸
曷 藒	艸 禾
耦 藕	艸
遬 藗	艸
毅 藙	艸
黎 藜	艸
乙 艺	艸
磊 藞	艸
畾 藟	艸
皛 藠	艸
適 藡	艸
徵 藢	艸
滕 藤	艸
约 药	艸
摩 藦	艸
麃 藨	艸
潘 藩	艸
数 薮	艸
蕈 藫	氵
窮 藭	艸
樵 藮	艸
慰 藯	艸
廆 藱	艸
稾 藳	艸
缊 蕴	艸
历 苈	艸
猪 蕏	艸
谒 蔼	艸
隹 蔺	艸 门
澡 藻	艸
憲 藼	艸
親 藽	艸
霍 藿	艸
择 萚	艸
噩 蘁	艸
橤 蘂	艸
木 蘃	艸 歮
斤 蕲	艸 单
衡 蘅	艸
户 芦	艸
办 苏	艸
侵 蘉	艸 罒 冖
缊 蕴	艸
平 苹	艸
禦 蘌	艸
熏 薫	艸
肥 蘎	艸 雨
磨 蘑	艸
檗 蘖	艸
檗 蘗	艸
襄 蘘	艸
翳 蘙	艸
鲜 藓	艸
育 蘛	艸 甚
鞠 蘜	艸
敛 蔹	艸
女 蘡	艸 真 真
龙 茏	艸
蘣
龠 蘥	艸
霝 蘦	艸
豦 蘧	艸
系 蘨	艸 爫 缶
繁 蘩	艸
麋 蘪	艸
三 兰	丷
罽 蘮	艸
盪 蘯	艸
壘 蘲	艸
蘳
豊 蘴	艸
魏 蘶	艸
夒 蘷	艸
灬 蘸	艸 酉 隹
懷 蘹	艸
离 蓠	艸
靡 蘼	艸
櫐 蘽	艸
壞 蘾	艸
罗 萝	艸
韲 虀	艸
夒 虁	艸 卝
露 虂	艸
纍 虆	艸
雚 虇	艸 弓
釁 虋	艸
鼈 虌	艸
七 虍	丨 一 厂
儿 虎	虍
一 虐	虍 匸
虎 虒	厂
虎 虓	九
文 虔	虍
卜 处	夂
乎 虖	虍
丘 虗	虍
且 虘	虍
必 虙	虍
业 虚	虍
力 虏	虍
勿 虝	虎
吴 虞	虍
丂 号	口
虎 虠	交
八 虡	虍 丱 一
虎 虢	寽
虎 虣	武
虎 虤	虎
丂 亏	一
彬 虨	虍
虎 虩	小 日 小
儵 虪	虎
刀 虭	虫
乚 虬	虫
丁 虰	虫
虫 虱	乁 一
勺 虳	虫
乇 虴	虫
衆 虵	虫
于 虶	虫
干 虷	虫
子 虸	虫
工 虹	虫
虫 虺	兀
亡 虻	虫
乞 虼	虫
方 蚄	虫
厄 蚅	虫
巴 蚆	虫
尺 蚇	虫
开 蚈	虫
虫 蚉	文
文 蚊	虫
内 蚋	虫
丰 蚌	虫
比 蚍	虫
日 蚎	虫
月 蚏	虫
勻 蚐	虫
支 蚑	虫
丹 蚒	虫
引 蚓	虫
氏 蚔	虫
元 蚖	虫
夬 蚗	虫
尤 蚘	虫
今 蚙	虫
斤 蚚	虫
中 蚛	虫
牙 蚜	虫
毛 蚝	虫
木 蚞	虫
王 蚟	虫
虫 蚠	分
分 蚡	虫
亢 蚢	虫
公 蚣	虫
虫 蚤	叉 丶
父 蚥	虫
冄 蚦	虫
介 蚧	虫
夫 蚨	虫
蚩
斗 蚪	虫
包 蚫	虫
尼 蚭	虫
代 蚮	虫
丘 蚯	虫
由 蚰	虫
乍 蚱	虫
平 蚲	虫
氐 蚳	虫
幼 蚴	虫
可 蚵	虫
甘 蚶	虫
巨 蚷	虫
斥 蚸	虫
付 蚹	虫
冉 蚺	虫
虫 蚻	札
句 蚼	虫
丕 蚽	虫
皮 蚾	虫
玄 蚿	虫
主 蛀	虫
召 蛁	虫
犮 蛂	虫
丙 蛃	虫
古 蛄	虫
占 蛅	虫
且 蛆	虫
它 蛇	虫
失 蛈	虫
令 蛉	虫
虫 蛋	疋
瓜 蛌	虫
虫 萤	艸 冖
曲 蛐	虫
牟 蛑	虫
各 蛒	虫
蛓
回 蛔	虫
有 蛕	虫
尨 蛖	虫
虫 蛗	户 乛 一
羊 蛘	虫
圭 蛙	虫
列 蛚	虫
朱 蛛	虫
伊 蛜	虫
艮 蛝	虫
舌 蛞	虫
交 蛟	虫
劦 蛠	虫
羽 蛡	虫
并 蛢	虫
吉 蛣	虫
合 蛤	虫
多 蛥	虫
夷 蛦	虫
百 蛨	虫
虫 蛩	巩
虫 蛪	丰 刀
危 蛫	虫
虫 蛬	共
至 蛭	虫
寽 蛶	虫
求 蛷	虫
肖 蛸	虫
甬 蛹	虫
夹 蛱	虫
兑 蜕	虫
我 蛾	虫
含 蛿	虫
虫 蜀	罒 勹
疋 蜁	虫 丿 一
夆 蜂	虫
虫 蜃	辰
辰 蜄	虫
甫 蜅	虫
见 蚬	虫
虫 蜇	折
吴 蜈	虫
孚 蜉	虫
利 蜊	虫
良 蜋	虫
土 蜌	虫 比
余 蜍	虫
肙 蜎	虫
秀 蜏	虫
虫 蜑	延
延 蜒	虫
廷 蜓	虫
甸 蜔	虫
回 蛔	虫
知 蜘	虫
松 蜙	虫
非 蜚	虫
居 蜛	虫
虫 蜜	宓
虫 蜝	其
其 蜞	虫
育 蜟	虫
囷 蜠	虫
孟 蜢	虫
羌 蜣	虫
虫 蜤	析
析 蜥	虫
戾 蜧	虫
疌 蜨	虫
周 蜩	虫
匋 蜪	虫
昆 蜫	虫
函 蜬	虫
臽 蜭	虫
或 蜮	虫
奉 蜯	虫
虫 蜰	肥
卑 蜱	虫
委 蜲	虫
享 蜳	虫
易 蜴	虫
卒 蜶	虫
卷 蜷	虫
芮 蜹	虫
兒 蜺	虫
青 蜻	虫
隹 蜼	虫
果 蜾	虫
宛 蜿	虫
版 蝂	虫
叕 蝃	虫
网 蛧	虫
虫 蝅	天 天
芈 蝆	虫
昔 蜡	虫
科 蝌	虫
即 蝍	虫
曷 蝎	虫
亭 蝏	虫
冒 蝐	虫
胥 蝑	虫
面 蝒	虫
俞 蝓	虫
皆 蝔	虫
虫 蚀	饣
宣 蝖	虫
皇 蝗	虫
匽 蝘	虫
扁 蝙	虫
柔 蝚	虫
威 蝛	虫
彖 蝝	虫
眉 蝞	虫
胃 猬	犭
畐 蝠	虫
耎 蝡	虫
斿 蝣	虫
酋 蝤	虫
虫 蝥	敄
下 虾	虫
英 蝧	虫
虫 虱	乁 一
重 蝩	虫
者 蝫	虫
是 蝭	虫
复 蝮	虫
爰 蝯	虫
奎 蝰	虫
虫 蝱	亡 虫
剌 蝲	虫
毒 蝳	虫
胡 蝴	虫
虫 蝵	秋
枼 蝶	虫
屰 蝷	虫 广
呙 蜗	虫
昷 蝹	虫
禹 蝺	虫
南 蝻	虫
春 蝽	虫
黾 蝇	虫
郎 螂	虫
旁 螃	虫
师 蛳	虫
息 螅	虫
兹 螆	虫
奚 螇	虫
原 螈	虫
翁 螉	虫
兼 螊	虫
叟 螋	虫
虫 螌	般
虫 融	鬲
鬲 螎	虫
疾 螏	虫
臭 螑	虫
虫 螒	十 日 十 人
秦 螓	虫
虒 螔	虫
比 螕	虫 囟
骨 螖	虫
唐 螗	虫
虫 螙	木 虫
虫 螚	能
害 螛	虫
虫 螜	士 冖 殳
鬼 螝	虫
马 蚂	虫
冥 螟	虫
益 螠	虫
虫 螡	文 虫
虫 萤	艹 冖
虫 螣	𠔉
臾 螤	蚉
商 螪	虫
虫 螫	赦
曹 螬	虫
离 螭	虫
虫 螯	敖